AAAGATGAGAGGTTGC-0	B_Naive
AAAGATGAGCGAGAAA-0	B_Naive
AAAGATGAGCTAGTGG-0	B_Naive
AAAGATGGTCTGCAAT-0	B_Naive
AAAGCAAAGTTGTCGT-0	B_Mem
AAAGCAACAGAGCCAA-0	B_Naive
AAAGTAGAGCCAGGAT-0	B_Naive
AACCATGTCGGCCGAT-0	B_Preplasma
AACCATGTCTTTCCTC-0	B_Naive
AACCGCGAGTGGAGAA-0	B_Preplasma
AACCGCGAGTTGAGAT-0	B_Naive
AACTCAGGTCGCGGTT-0	B_Naive
AACTCAGTCTGGAGCC-0	B_Naive
AACTCCCAGACTGGGT-0	B_Naive
AACTCTTAGTTCGCAT-0	B_Mem_Prolif
AACTCTTTCTGCTGTC-0	B_Naive
AACTGGTCACGCATCG-0	B_Naive
AACTGGTGTACGCTGC-0	B_Naive
AACTGGTGTCTCCACT-0	B_Mem_Prolif
AACTGGTTCTCTGAGA-0	B_Naive
AACTTTCGTGATAAAC-0	B_Naive
AAGACCTAGCGTCTAT-0	B_Naive
AAGACCTCAGTTCCCT-0	B_Naive
AAGGCAGAGATCGGGT-0	B_Naive
AAGGCAGGTCTCTTTA-0	B_Mem
AAGGCAGGTGTTCGAT-0	B_Mem_Prolif
AAGGCAGGTTGCTCCT-0	B_Mem_Prolif
AAGGTTCAGAAGGTTT-0	B_Naive
AAGGTTCCATCGGTTA-0	B_Naive
AAGGTTCGTTGCTCCT-0	B_Naive
AAGTCTGAGGCTCATT-0	B_Naive
AAGTCTGAGTGAACAT-0	B_Naive
AATCCAGAGGCCCTTG-0	B_Mem
AATCCAGCACTTAACG-0	B_Naive
AATCCAGGTACGCTGC-0	B_Naive
AATCCAGGTTGGTGGA-0	B_Naive
AATCGGTCACAGATTC-0	B_Mem_Prolif
AATCGGTCAGCATGAG-0	B_Mem
ACACCAAAGGATTCGG-0	B_Naive
ACACCAACAAACGCGA-0	B_Naive
ACACCAAGTGCAGGTA-0	B_Naive
ACACCAAGTTGATTGC-0	B_Naive
ACACCAATCGGTTCGG-0	B_Naive
ACACCCTCATATGGTC-0	B_Naive
ACACCCTGTAATCGTC-0	B_Mem_Prolif
ACACCCTGTCCAGTGC-0	B_Naive
ACACTGAAGATCGATA-0	B_Naive
ACACTGAAGTATCGAA-0	B_Naive
ACAGCCGAGAAGATTC-0	B_Mem
ACAGCCGCAGATGAGC-0	B_Preplasma
ACAGCTAAGCAATCTC-0	B_Naive
ACAGCTACACTGCCAG-0	B_Naive
ACAGCTATCATTTGGG-0	B_Naive
ACATACGCAAGGACAC-0	B_Mem_Prolif
ACATACGCACCAGATT-0	B_Naive
ACATACGGTCATTAGC-0	B_Naive
ACATCAGCAAATCCGT-0	B_Naive
ACATCAGGTATAGGTA-0	B_Mem
ACATCAGGTCCGAACC-0	B_Naive
ACATCAGTCCGCGTTT-0	B_Naive
ACATCAGTCGTGGTCG-0	B_Mem_Prolif
ACATGGTAGCTAGGCA-0	B_Naive
ACATGGTAGGAACTGC-0	B_Naive
ACATGGTGTCACAAGG-0	B_Mem_Prolif
ACATGGTTCACGCATA-0	B_Mem_Prolif
ACCAGTACACACCGAC-0	B_Naive
ACCAGTATCACCTCGT-0	B_Mem_Prolif
ACCCACTAGGACCACA-0	B_Naive
ACCCACTTCTCGTATT-0	B_Naive
ACCGTAACACTCTGTC-0	B_Naive
ACCGTAAGTTCGCGAC-0	B_Mem
ACCTTTATCAACCAAC-0	B_Mem_Prolif
ACCTTTATCAATCACG-0	B_Mem
ACGAGCCAGCTAACAA-0	B_Preplasma
ACGAGCCTCAAGATCC-0	B_Naive
ACGAGGACAGATCTGT-0	B_Naive
ACGATACAGGCTCAGA-0	B_Naive
ACGATGTGTACAGTTC-0	B_Naive
ACGATGTTCGTTTATC-0	B_Naive
ACGATGTTCTGATACG-0	B_Naive
ACGGAGAAGAAGGACA-0	B_Naive
ACGGCCACACCGATAT-0	B_Naive
ACGGGCTTCAACGGCC-0	B_Naive
ACGGGTCAGTTGTCGT-0	B_Naive
ACGTCAACACGCGAAA-0	B_Mem
ACGTCAATCTCAAGTG-0	B_Naive
ACTATCTAGGCCCGTT-0	B_Mem
ACTGAGTAGGCCCTTG-0	B_Naive
ACTGAGTCACGAAAGC-0	B_Naive
ACTGAGTGTAATTGGA-0	B_Mem_Prolif
ACTGATGAGTGTACGG-0	B_Naive
ACTGCTCCACATTAGC-0	B_Preplasma
ACTGCTCGTGATGTGG-0	B_Mem_Prolif
ACTTGTTAGTTGAGTA-0	B_Mem
ACTTTCACATACTCTT-0	B_Naive
AGAATAGAGACTGGGT-0	B_Naive
AGAATAGAGCGGATCA-0	B_Naive
AGAATAGCAACACCTA-0	B_Naive
AGACGTTAGAATGTTG-0	B_Preplasma
AGACGTTAGCCAGGAT-0	B_Preplasma
AGACGTTCAGGGTTAG-0	B_Naive
AGAGCGACACTCGACG-0	B_Mem
AGAGCGAGTATAGTAG-0	B_Naive
AGAGCTTCATGTCGAT-0	B_Naive
AGAGCTTTCGGTCCGA-0	B_Naive
AGAGTGGTCTTGTATC-0	B_Naive
AGATCTGCATCAGTCA-0	B_Naive
AGATTGCAGATCCTGT-0	B_Naive
AGATTGCGTCTAGTCA-0	B_Preplasma
AGATTGCGTGACTCAT-0	B_Naive
AGATTGCTCCGCATAA-0	B_Mem_Prolif
AGCAGCCCACATAACC-0	B_Naive
AGCAGCCCATGACATC-0	B_Mem
AGCATACCAAGCCGTC-0	B_Naive
AGCATACGTACTTGAC-0	B_Mem
AGCATACGTTCCAACA-0	B_Mem
AGCATACGTTCGCTAA-0	B_Naive
AGCATACTCTGATTCT-0	B_Naive
AGCCTAACATTGGTAC-0	B_Naive
AGCCTAAGTAAGGGAA-0	B_Naive
AGCCTAAGTTCGGCAC-0	B_Naive
AGCGGTCCAGGGATTG-0	B_Naive
AGCGTATCAAGAAAGG-0	B_Naive
AGCGTATTCTCGTATT-0	B_Naive
AGCTCCTGTTGCGCAC-0	B_Naive
AGCTCCTTCGTGGGAA-0	B_Mem_Prolif
AGCTCTCCACGTCTCT-0	B_Naive
AGCTCTCCAGTCCTTC-0	B_Preplasma
AGCTCTCGTATTAGCC-0	B_Naive
AGCTCTCTCATGCAAC-0	B_Naive
AGCTTGAGTGTTTGTG-0	B_Naive
AGCTTGATCAATCACG-0	B_Naive
AGCTTGATCGGTGTTA-0	B_Preplasma
AGGCCGTAGAACAATC-0	B_Naive
AGGCCGTAGATGAGAG-0	B_Mem
AGGCCGTTCGAGAACG-0	B_Naive
AGGGATGAGGGTTTCT-0	B_Naive
AGGGATGCATCCTAGA-0	B_Naive
AGGGATGGTGAGTGAC-0	B_Naive
AGGGTGAAGGGTCGAT-0	B_Naive
AGGGTGACATTACGAC-0	B_Naive
AGGTCATAGGATATAC-0	B_Naive
AGGTCCGCATACCATG-0	B_Mem
AGTCTTTGTTGTCGCG-0	B_Naive
AGTGAGGGTTGACGTT-0	B_Preplasma
AGTGAGGTCTTTCCTC-0	B_Naive
AGTGGGAAGACAGGCT-0	B_Naive
AGTGGGATCTGAGGGA-0	B_Naive
AGTGTCATCGCGATCG-0	B_Naive
AGTTGGTCACAACTGT-0	B_Naive
AGTTGGTCAGTCAGCC-0	B_Naive
AGTTGGTTCTCTTATG-0	B_Naive
ATAACGCTCCTTGGTC-0	B_Naive
ATAGACCTCGAGGTAG-0	B_Naive
ATCACGAAGTGTACCT-0	B_Mem
ATCACGATCGGATGTT-0	B_Naive
ATCATCTCATTTGCCC-0	B_Mem_Prolif
ATCATCTTCGGCGGTT-0	B_Preplasma
ATCCACCAGTATCGAA-0	B_Mem_Prolif
ATCCGAACACCCTATC-0	B_Naive
ATCCGAACATTGTGCA-0	B_Mem
ATCCGAAGTCTCCACT-0	B_Preplasma
ATCGAGTGTTGCGCAC-0	B_Naive
ATCTACTGTAGCGTGA-0	B_Mem
ATCTGCCGTATTACCG-0	B_Naive
ATGAGGGAGGTCATCT-0	B_Mem
ATGAGGGGTTGGACCC-0	B_Mem
ATGCGATCAGCTGGCT-0	B_Mem_Prolif
ATGGGAGAGCCAGAAC-0	B_Mem
ATGTGTGGTCGACTGC-0	B_Naive
ATTATCCAGTCACGCC-0	B_Naive
ATTATCCCAACACGCC-0	B_Naive
ATTATCCTCACCAGGC-0	B_Mem_Prolif
ATTCTACAGAGCAATT-0	B_Naive
ATTCTACCAAGCCATT-0	B_Mem
ATTCTACCATCTACGA-0	B_Naive
ATTCTACGTCTTCGTC-0	B_Naive
ATTCTACTCGAATGGG-0	B_Preplasma
ATTGGACGTACCATCA-0	B_Naive
ATTGGACTCCGAACGC-0	B_Naive
ATTGGTGAGAAGGTGA-0	B_Naive
ATTGGTGAGTGGAGAA-0	B_Naive
ATTTCTGAGAGGTTAT-0	B_Mem
ATTTCTGCATTTCACT-0	B_Naive
ATTTCTGGTCACTTCC-0	B_Preplasma
CAACCAACAATGACCT-0	B_Naive
CAACCTCTCTAACTGG-0	B_Naive
CAACTAGAGTTGTAGA-0	B_Naive
CAAGAAATCACCACCT-0	B_Naive
CAAGATCAGATGTCGG-0	B_Naive
CAAGATCGTCATATCG-0	B_Naive
CAAGGCCAGTACGATA-0	B_Mem_Prolif
CAAGGCCCATACTCTT-0	B_Preplasma
CAAGGCCGTCCGAACC-0	B_Mem_Prolif
CACAAACAGAGACTAT-0	B_Naive
CACAAACAGGACGAAA-0	B_Naive
CACAAACCAATTGCTG-0	B_Naive
CACAAACGTTCGTTGA-0	B_Naive
CACACAAAGCAGGTCA-0	B_Naive
CACACAACAAGACGTG-0	B_Naive
CACACAAGTTTGTTTC-0	B_Naive
CACACCTCATCTATGG-0	B_Naive
CACACTCAGAAACCAT-0	B_Naive
CACACTCAGCAAATCA-0	B_Naive
CACACTCGTGAGCGAT-0	B_Naive
CACAGGCAGTTGAGAT-0	B_Naive
CACAGGCGTTCGTTGA-0	B_Preplasma
CACAGGCTCGTTTGCC-0	B_Mem
CACAGTAAGAAACCAT-0	B_Naive
CACAGTAGTTCCAACA-0	B_Naive
CACATAGAGTCCAGGA-0	B_Naive
CACATAGGTATAAACG-0	B_Naive
CACATAGTCCGGGTGT-0	B_Naive
CACATTTAGTGGACGT-0	B_Naive
CACATTTCAGAAGCAC-0	B_Mem
CACATTTGTAAATACG-0	B_Naive
CACATTTGTACAGACG-0	B_Naive
CACATTTTCGGAGCAA-0	B_Mem_Prolif
CACCACTTCGCGGATC-0	B_Naive
CACCTTGCACTGAAGG-0	B_Mem
CACCTTGGTGACGGTA-0	B_Mem
CACCTTGGTGCACTTA-0	B_Naive
CACCTTGTCACCTTAT-0	B_Mem_Prolif
CACCTTGTCTGCGACG-0	B_Naive
CACTCCAGTTCTGAAC-0	B_Naive
CAGAATCCATTCCTCG-0	B_Mem_Prolif
CAGAGAGCAGTAAGCG-0	B_Naive
CAGATCACACGTCAGC-0	B_Naive
CAGATCAGTATCAGTC-0	B_Preplasma
CAGCAGCAGCGTTTAC-0	B_Mem_Prolif
CAGCATACAATGTAAG-0	B_Mem
CAGCATATCGTTACAG-0	B_Mem_Prolif
CAGCCGAAGCTAACTC-0	B_Preplasma
CAGCCGAGTTACCAGT-0	B_Naive
CAGCGACCAGGACGTA-0	B_Preplasma
CAGCGACGTATAAACG-0	B_Naive
CAGCGACGTCATACTG-0	B_Mem
CAGCGACTCCGCAGTG-0	B_Mem_Prolif
CAGCTAAAGCGATAGC-0	B_Naive
CAGCTAACAGACGCAA-0	B_Naive
CAGGTGCAGCCAGAAC-0	B_Naive
CAGGTGCTCTCTTATG-0	B_Mem
CAGTAACAGTCATGCT-0	B_Naive
CAGTAACCACGGCGTT-0	B_Mem
CAGTAACTCTAGCACA-0	B_Naive
CAGTCCTAGCACGCCT-0	B_Naive
CAGTCCTAGCCTTGAT-0	B_Mem
CAGTCCTCATGAGCGA-0	B_Mem_Prolif
CATATTCGTGACGGTA-0	B_Naive
CATATTCTCGGACAAG-0	B_Naive
CATCAAGAGCACCGTC-0	B_Mem_Prolif
CATCAAGAGGTGTTAA-0	B_Naive
CATCAAGCAGTATGCT-0	B_Naive
CATCAAGGTATTAGCC-0	B_Mem_Prolif
CATCAGACAGGACCCT-0	B_Naive
CATCAGACATACAGCT-0	B_Naive
CATCCACAGGAGTCTG-0	B_Naive
CATCCACTCGCTGATA-0	B_Naive
CATCGGGCAGCCAATT-0	B_Naive
CATCGGGTCGGAATCT-0	B_Naive
CATGACAAGCGTTGCC-0	B_Preplasma
CATGACAGTTCCGTCT-0	B_Mem_Prolif
CATGCCTAGGTACTCT-0	B_Naive
CATGCCTTCAGCAACT-0	B_Naive
CATGCCTTCGTTACAG-0	B_Naive
CATGGCGCAGGCGATA-0	B_Preplasma
CATGGCGGTGCACGAA-0	B_Mem_Prolif
CATGGCGGTGCTCTTC-0	B_Preplasma
CATTATCCAAGTCTGT-0	B_Naive
CATTATCGTATATCCG-0	B_Naive
CATTATCGTCCTCTTG-0	B_Naive
CATTATCGTTCCCGAG-0	B_Mem_Prolif
CATTCGCGTACCGTTA-0	B_Naive
CATTCGCTCGAACTGT-0	B_Naive
CATTCGCTCGAATCCA-0	B_Mem_Prolif
CCAATCCAGCTACCTA-0	B_Mem
CCACCTAAGAGCCTAG-0	B_Naive
CCACCTACAATGAAAC-0	B_Naive
CCACCTACATGCCTTC-0	B_Mem
CCACTACAGGGCTCTC-0	B_Naive
CCACTACGTATGGTTC-0	B_Preplasma
CCATGTCCAAAGTGCG-0	B_Mem_Prolif
CCATTCGAGCACGCCT-0	B_Naive
CCCAATCCACGCATCG-0	B_Naive
CCCAGTTTCCAGAAGG-0	B_Preplasma
CCCTCCTAGGCGATAC-0	B_Naive
CCCTCCTAGTCTTGCA-0	B_Mem
CCGGGATCAATAACGA-0	B_Naive
CCGGGATCACAGACTT-0	B_Naive
CCGGGATGTAGGGTAC-0	B_Naive
CCGTACTCATTCCTCG-0	B_Naive
CCGTACTGTGACTCAT-0	B_Naive
CCGTGGATCGAATGCT-0	B_Naive
CCGTTCAGTCCGAAGA-0	B_Naive
CCGTTCAGTCTGCAAT-0	B_Naive
CCTAAAGAGGGATACC-0	B_Naive
CCTAAAGAGGTCATCT-0	B_Naive
CCTAAAGCATGTAAGA-0	B_Mem_Prolif
CCTAAAGGTGACTACT-0	B_Naive
CCTAAAGTCACCGTAA-0	B_Mem
CCTACACAGATCCGAG-0	B_Naive
CCTACACAGTGGGATC-0	B_Naive
CCTACACCAGACACTT-0	B_Mem_Prolif
CCTACACGTCCGAATT-0	B_Naive
CCTACACTCACGATGT-0	B_Naive
CCTAGCTCAAGCGCTC-0	B_Naive
CCTAGCTCAGGGTACA-0	B_Naive
CCTAGCTCATCGGACC-0	B_Preplasma
CCTATTAGTCGAGATG-0	B_Mem_Prolif
CCTCAGTCATTCTCAT-0	B_Naive
CCTCAGTTCAAAGACA-0	B_Naive
CCTCTGAAGAAGGACA-0	B_Naive
CCTCTGAAGAGTCTGG-0	B_Preplasma
CCTCTGACAAGGACTG-0	B_Naive
CCTCTGACAATAGAGT-0	B_Preplasma
CCTCTGACACAGCCCA-0	B_Mem
CCTTCCCAGCATCATC-0	B_Naive
CCTTCCCCACACGCTG-0	B_Naive
CCTTCGAAGCGTGAGT-0	B_Naive
CCTTCGAAGTGGAGTC-0	B_Naive
CCTTCGACAAGCTGAG-0	B_Naive
CCTTTCTGTGGTACAG-0	B_Mem
CGAACATAGACTGGGT-0	B_Naive
CGAACATAGCAGATCG-0	B_Mem_Prolif
CGAACATCAATTGCTG-0	B_Naive
CGAACATGTCAATACC-0	B_Naive
CGAATGTCATCGATTG-0	B_Naive
CGACCTTGTCAGAGGT-0	B_Mem_Prolif
CGACCTTGTGCGATAG-0	B_Preplasma
CGACTTCGTTACCGAT-0	B_Mem_Prolif
CGAGAAGGTTACCAGT-0	B_Naive
CGAGAAGTCAACACTG-0	B_Naive
CGAGCACAGTCGAGTG-0	B_Naive
CGAGCACCAATGGAGC-0	B_Mem
CGAGCCACATACGCTA-0	B_Naive
CGATCGGTCCCTGACT-0	B_Naive
CGATGGCGTAATCGTC-0	B_Naive
CGATGGCGTGATGATA-0	B_Mem_Prolif
CGATGTAGTACGACCC-0	B_Naive
CGATGTAGTGACCAAG-0	B_Naive
CGATTGAAGACCTTTG-0	B_Preplasma
CGATTGACACTTACGA-0	B_Naive
CGATTGACAGTTAACC-0	B_Preplasma
CGATTGAGTCCAAGTT-0	B_Preplasma
CGATTGATCGGCGCTA-0	B_Naive
CGCCAAGAGGATGCGT-0	B_Naive
CGCGGTACACGCTTTC-0	B_Naive
CGCGGTACATGGTAGG-0	B_Naive
CGCGTTTAGTTACGGG-0	B_Naive
CGCGTTTCAGTAACGG-0	B_Naive
CGCTATCAGCGTTGCC-0	B_Mem_Prolif
CGCTATCAGTTTAGGA-0	B_Naive
CGGACACGTGGACGAT-0	B_Naive
CGGACACTCCACTGGG-0	B_Mem_Prolif
CGGACGTAGACTCGGA-0	B_Mem_Prolif
CGGACGTTCAACACAC-0	B_Naive
CGGACTGAGGCAGGTT-0	B_Naive
CGGACTGCAAAGAATC-0	B_Mem_Prolif
CGGACTGCAGTCCTTC-0	B_Mem
CGGACTGGTCCCTACT-0	B_Mem_Prolif
CGGACTGGTTCCCGAG-0	B_Naive
CGGACTGTCCTGCCAT-0	B_Mem_Prolif
CGGACTGTCGATGAGG-0	B_Naive
CGGAGCTAGCTCCTTC-0	B_Naive
CGGAGCTCAGTACACT-0	B_Naive
CGGCTAGCAGACAGGT-0	B_Naive
CGGGTCAAGGCTAGAC-0	B_Naive
CGGGTCAGTTACCGAT-0	B_Naive
CGGGTCATCGAATGCT-0	B_Preplasma
CGGTTAAAGTGTTTGC-0	B_Naive
CGGTTAATCATAGCAC-0	B_Mem_Prolif
CGTAGCGAGGCTAGGT-0	B_Mem
CGTAGCGCAATCGAAA-0	B_Mem
CGTAGCGTCTTAACCT-0	B_Naive
CGTAGCGTCTTGTTTG-0	B_Mem
CGTAGGCAGATAGCAT-0	B_Preplasma
CGTCACTAGCGAGAAA-0	B_Mem_Prolif
CGTCACTCACAAGTAA-0	B_Naive
CGTCACTCATGACATC-0	B_Naive
CGTCAGGAGGAGTCTG-0	B_Naive
CGTCAGGGTCGAATCT-0	B_Naive
CGTCAGGTCATGTCTT-0	B_Preplasma
CGTCAGGTCCGAGCCA-0	B_Mem
CGTCAGGTCGGTCTAA-0	B_Naive
CGTCCATAGCGTGAGT-0	B_Preplasma
CGTCCATGTAGTGAAT-0	B_Naive
CGTCCATGTTCGTTGA-0	B_Mem
CGTCTACCAGGTCCAC-0	B_Naive
CGTGAGCAGTACGCGA-0	B_Preplasma
CGTGAGCGTTGCCTCT-0	B_Mem_Prolif
CGTTCTGAGTCAAGGC-0	B_Naive
CGTTCTGGTCTGATCA-0	B_Naive
CGTTGGGGTCTCCACT-0	B_Naive
CGTTGGGGTTATCCGA-0	B_Naive
CGTTGGGTCACTATTC-0	B_Naive
CTAACTTAGAGGACGG-0	B_Naive
CTAAGACCATGCAATC-0	B_Naive
CTAAGACTCGCTTAGA-0	B_Mem_Prolif
CTAAGACTCGGAGCAA-0	B_Naive
CTAAGACTCTGTCTCG-0	B_Naive
CTAATGGTCCAAACTG-0	B_Mem_Prolif
CTACACCCAGCCTTTC-0	B_Naive
CTACACCTCCGATATG-0	B_Naive
CTACATTGTCTCCACT-0	B_Naive
CTACATTGTTTCGCTC-0	B_Naive
CTACATTTCCACGTTC-0	B_Naive
CTACCCAAGATACACA-0	B_Naive
CTACGTCAGAGCTGGT-0	B_Naive
CTAGAGTGTCTAGTGT-0	B_Preplasma
CTAGTGAGTACCCAAT-0	B_Naive
CTCACACGTGTTTGGT-0	B_Mem
CTCACACGTTCCCTTG-0	B_Naive
CTCAGAACACACATGT-0	B_Naive
CTCAGAATCAAACCAC-0	B_Naive
CTCATTACAGGCTCAC-0	B_Naive
CTCATTATCCGCAAGC-0	B_Naive
CTCCTAGAGTGGGATC-0	B_Naive
CTCCTAGGTCCATCCT-0	B_Mem
CTCCTAGTCATATCGG-0	B_Naive
CTCCTAGTCGTGGGAA-0	B_Naive
CTCGAAAGTAATTGGA-0	B_Naive
CTCGAAAGTCGTCTTC-0	B_Naive
CTCGAAAGTTCCGGCA-0	B_Naive
CTCGAGGAGGCATGGT-0	B_Naive
CTCGAGGGTGGCAAAC-0	B_Naive
CTCGGAGAGTCCATAC-0	B_Naive
CTCGTACGTTCTGTTT-0	B_Naive
CTCGTCAAGCGCTTAT-0	B_Preplasma
CTCGTCACAGCTGTTA-0	B_Naive
CTCGTCAGTGTCGCTG-0	B_Mem_Prolif
CTCGTCAGTGTTAAGA-0	B_Mem_Prolif
CTCTAATAGCGAAGGG-0	B_Preplasma
CTCTAATAGGACACCA-0	B_Naive
CTCTAATAGTAATCCC-0	B_Naive
CTCTACGGTTATCCGA-0	B_Mem_Prolif
CTCTGGTAGTGGCACA-0	B_Naive
CTCTGGTGTCTTCAAG-0	B_Naive
CTCTGGTGTGGTCTCG-0	B_Naive
CTGAAACGTATAGGGC-0	B_Naive
CTGAAACTCAGTACGT-0	B_Naive
CTGAAGTTCAAGAAGT-0	B_Naive
CTGAAGTTCTGCGACG-0	B_Naive
CTGATAGAGGTGGGTT-0	B_Naive
CTGATAGTCCTAAGTG-0	B_Mem_Prolif
CTGATCCAGGCGATAC-0	B_Naive
CTGATCCCATGAACCT-0	B_Mem_Prolif
CTGATCCGTCTCAACA-0	B_Naive
CTGCCTAAGCACACAG-0	B_Naive
CTGCCTACAGGACGTA-0	B_Naive
CTGCGGAGTGTGGTTT-0	B_Mem_Prolif
CTGCGGATCAGGCGAA-0	B_Preplasma
CTGCTGTAGAGGGATA-0	B_Naive
CTGCTGTCAATAGCGG-0	B_Preplasma
CTGCTGTGTACGCACC-0	B_Naive
CTGCTGTTCGATCCCT-0	B_Preplasma
CTGCTGTTCTGCTGCT-0	B_Preplasma
CTGTTTATCCGAAGAG-0	B_Mem
CTTAACTCAATGGAGC-0	B_Naive
CTTACCGGTAGGGTAC-0	B_Naive
CTTACCGTCTGTTTGT-0	B_Preplasma
CTTAGGAAGGCTAGGT-0	B_Mem_Prolif
CTTAGGATCCCAAGAT-0	B_Naive
CTTAGGATCGTTTGCC-0	B_Mem
CTTGGCTCAGTAACGG-0	B_Mem
CTTTGCGGTCGGATCC-0	B_Mem
CTTTGCGTCTTCGGTC-0	B_Naive
GAAATGACAAGGGTCA-0	B_Naive
GAAATGACATACCATG-0	B_Naive
GAAATGAGTCGCCATG-0	B_Naive
GAACATCGTCTAAAGA-0	B_Mem_Prolif
GAACATCTCCGAACGC-0	B_Mem
GAACATCTCCGCATAA-0	B_Preplasma
GAACCTAGTAGCTGCC-0	B_Naive
GAACCTAGTTCGTGAT-0	B_Naive
GAACGGACATACCATG-0	B_Naive
GAACGGAGTATTCGTG-0	B_Naive
GAAGCAGTCTACGAGT-0	B_Preplasma
GAATAAGAGCACGCCT-0	B_Naive
GAATGAACAAGGGTCA-0	B_Naive
GACACGCAGAGAGCTC-0	B_Mem_Prolif
GACAGAGCAGCTGTTA-0	B_Mem_Prolif
GACAGAGTCTGTCTCG-0	B_Mem_Prolif
GACCAATCACCAGTTA-0	B_Naive
GACCAATGTAACGCGA-0	B_Naive
GACCAATTCGCGTAGC-0	B_Naive
GACCAATTCGTGGTCG-0	B_Naive
GACCTGGAGGTAAACT-0	B_Naive
GACCTGGCATTCTTAC-0	B_Naive
GACCTGGTCATATCGG-0	B_Naive
GACGCGTAGCGTGAAC-0	B_Naive
GACGGCTGTTCCTCCA-0	B_Naive
GACGTTACAAACGTGG-0	B_Naive
GACTAACAGTCAATAG-0	B_Mem
GACTAACCAAGCCCAC-0	B_Naive
GACTACATCAAAGACA-0	B_Naive
GACTGCGGTTGTCGCG-0	B_Naive
GAGCAGAAGAAACCAT-0	B_Naive
GAGCAGACAAGCTGAG-0	B_Naive
GAGGTGAGTATATGAG-0	B_Naive
GAGGTGAGTTCCAACA-0	B_Naive
GAGTCCGCATAGAAAC-0	B_Naive
GAGTCCGGTGTGAAAT-0	B_Mem
GATCAGTGTAACGCGA-0	B_Naive
GATCAGTTCGTACCGG-0	B_Preplasma
GATCGATAGTCCGGTC-0	B_Naive
GATCGATCAATGTTGC-0	B_Naive
GATCGATTCTAACCGA-0	B_Naive
GATCGCGAGGACACCA-0	B_Naive
GATCGCGCAGGTTTCA-0	B_Naive
GATCGCGTCAGAGACG-0	B_Naive
GATCGTAGTTTACTCT-0	B_Naive
GATCTAGAGTTAGGTA-0	B_Naive
GATCTAGGTCTTCTCG-0	B_Mem_Prolif
GATGAAACATCTACGA-0	B_Naive
GATGAGGGTACTCTCC-0	B_Mem
GATGAGGTCTTGTCAT-0	B_Naive
GATGCTAAGATAGCAT-0	B_Naive
GCAAACTAGCCCGAAA-0	B_Preplasma
GCAAACTGTGCCTGCA-0	B_Naive
GCAATCACACATGGGA-0	B_Naive
GCACATAAGTGCGATG-0	B_Naive
GCAGCCACATCAGTCA-0	B_Naive
GCAGCCAGTAATAGCA-0	B_Mem_Prolif
GCAGCCATCACCCTCA-0	B_Naive
GCAGTTAAGCACCGCT-0	B_Naive
GCATACAGTAAGAGAG-0	B_Naive
GCATACATCTTGCATT-0	B_Naive
GCATGATCACGCGAAA-0	B_Naive
GCATGATGTCAGTGGA-0	B_Mem_Prolif
GCATGATTCTGACCTC-0	B_Mem_Prolif
GCATGCGCAGGACCCT-0	B_Preplasma
GCATGTACATTTGCTT-0	B_Mem_Prolif
GCATGTAGTAGTAGTA-0	B_Preplasma
GCATGTATCACCTCGT-0	B_Naive
GCCAAATTCCAGTAGT-0	B_Mem_Prolif
GCCAAATTCTGTCCGT-0	B_Mem_Prolif
GCCTCTAAGGTGCAAC-0	B_Naive
GCGACCACAATCCAAC-0	B_Mem
GCGACCAGTGATGCCC-0	B_Mem_Prolif
GCGAGAACATTGAGCT-0	B_Naive
GCGAGAAGTATAGTAG-0	B_Preplasma
GCGCAACAGAGGTAGA-0	B_Naive
GCGCAACGTGCCTGTG-0	B_Naive
GCGCAACGTTCCATGA-0	B_Naive
GCGCAGTCATCGACGC-0	B_Naive
GCGCAGTGTAAATGAC-0	B_Preplasma
GCGCAGTTCCAAACAC-0	B_Mem_Prolif
GCGCAGTTCTGTCTAT-0	B_Naive
GCGCGATTCTCGTTTA-0	B_Mem_Prolif
GCGGGTTAGCCACGCT-0	B_Preplasma
GCGGGTTGTTGTCTTT-0	B_Mem_Prolif
GCGGGTTTCATCGGAT-0	B_Naive
GCTCTGTAGCTACCGC-0	B_Mem
GCTCTGTCAGACGCAA-0	B_Naive
GCTCTGTGTTGTACAC-0	B_Naive
GCTGCAGGTTGTTTGG-0	B_Naive
GCTGCGAAGACTAGGC-0	B_Naive
GCTGCGACAGGTTTCA-0	B_Mem
GCTGCTTTCTATGTGG-0	B_Mem
GCTTCCATCACTATTC-0	B_Naive
GCTTGAACAGAGTGTG-0	B_Naive
GCTTGAAGTCTTCAAG-0	B_Naive
GGAACTTGTCTCAACA-0	B_Naive
GGAATAACAGGATTGG-0	B_Naive
GGAATAAGTATATGGA-0	B_Mem_Prolif
GGACAAGGTAGAGTGC-0	B_Naive
GGACGTCGTTCTCATT-0	B_Preplasma
GGAGCAAAGGTGATTA-0	B_Naive
GGATGTTGTCCGAACC-0	B_Mem_Prolif
GGATGTTTCCGTAGGC-0	B_Preplasma
GGCAATTCACGAAACG-0	B_Naive
GGCCGATGTAGGGACT-0	B_Naive
GGCCGATGTAGTAGTA-0	B_Preplasma
GGCCGATTCCTCTAGC-0	B_Mem_Prolif
GGCGACTCAGCCTATA-0	B_Naive
GGCGACTTCAAACGGG-0	B_Naive
GGCGTGTCACTACAGT-0	B_Naive
GGCTCGAAGTTGAGAT-0	B_Naive
GGCTCGACAGGCTGAA-0	B_Mem
GGCTGGTAGGGTGTTG-0	B_Naive
GGCTGGTAGTATTGGA-0	B_Mem_Prolif
GGCTGGTTCTTTAGGG-0	B_Naive
GGGACCTTCCGTTGCT-0	B_Mem_Prolif
GGGAGATAGTGTACCT-0	B_Naive
GGGATGAAGTGGGCTA-0	B_Naive
GGGATGATCCTACAGA-0	B_Naive
GGGATGATCTATCCTA-0	B_Naive
GGGCACTCAAGGTGTG-0	B_Naive
GGGCATCCAAACGTGG-0	B_Naive
GGGCATCGTCTACCTC-0	B_Naive
GGGTCTGCAATACGCT-0	B_Naive
GGGTCTGGTCTACCTC-0	B_Mem
GGGTTGCCATGCTAGT-0	B_Preplasma
GGGTTGCTCCCACTTG-0	B_Naive
GGTATTGAGATGCCTT-0	B_Naive
GGTATTGCACACCGAC-0	B_Preplasma
GGTGAAGGTAAGGATT-0	B_Naive
GGTGTTAGTTCCTCCA-0	B_Naive
GGTGTTATCGGTTAAC-0	B_Naive
GGTGTTATCTCTAAGG-0	B_Naive
GTAACGTGTCAGTGGA-0	B_Mem_Prolif
GTAACTGTCTGCTGCT-0	B_Mem
GTACGTAAGAAACGAG-0	B_Naive
GTACGTAAGATGCGAC-0	B_Mem
GTACGTACAGCGTAAG-0	B_Naive
GTACGTACAGTCACTA-0	B_Naive
GTACGTATCGGATGTT-0	B_Preplasma
GTACTCCAGCCAGTTT-0	B_Naive
GTACTTTCACTTCTGC-0	B_Mem_Prolif
GTAGGCCAGGCCATAG-0	B_Naive
GTAGGCCCACCTATCC-0	B_Mem
GTAGGCCTCAGAAATG-0	B_Naive
GTAGGCCTCCGTACAA-0	B_Naive
GTAGGCCTCTGTTGAG-0	B_Naive
GTAGTCAAGACTAGGC-0	B_Naive
GTAGTCAAGCTAACTC-0	B_Naive
GTAGTCACACACAGAG-0	B_Preplasma
GTATCTTTCAGGTTCA-0	B_Naive
GTATTCTCATGCTAGT-0	B_Naive
GTCAAGTCAAAGCAAT-0	B_Naive
GTCAAGTGTACAAGTA-0	B_Preplasma
GTCAAGTTCGACGGAA-0	B_Naive
GTCACAATCAGCAACT-0	B_Mem
GTCACGGGTCATTAGC-0	B_Naive
GTCACGGGTGGCTCCA-0	B_Naive
GTCACGGTCCCATTAT-0	B_Naive
GTCACGGTCGGAGGTA-0	B_Naive
GTCATTTGTCCAAGTT-0	B_Naive
GTCGGGTCAATCTGCA-0	B_Naive
GTCGGGTGTTCGTGAT-0	B_Mem
GTCGTAATCCGAATGT-0	B_Naive
GTCTCGTCACTCGACG-0	B_Mem_Prolif
GTCTCGTCAGTAAGAT-0	B_Mem_Prolif
GTCTTCGCAGTCCTTC-0	B_Naive
GTCTTCGTCCTTTACA-0	B_Naive
GTGAAGGAGCTGTTCA-0	B_Naive
GTGAAGGAGGCTACGA-0	B_Mem_Prolif
GTGCAGCTCCCTAACC-0	B_Naive
GTGCATACACCAGCAC-0	B_Naive
GTGCATAGTCCCGACA-0	B_Naive
GTGCGGTAGTGGACGT-0	B_Naive
GTGCGGTTCGTAGATC-0	B_Mem_Prolif
GTGCTTCCATGGAATA-0	B_Mem
GTGGGTCAGATGTGTA-0	B_Naive
GTGGGTCCATTCTCAT-0	B_Naive
GTGGGTCTCCTCAACC-0	B_Preplasma
GTGTGCGGTCGAGTTT-0	B_Naive
GTGTGCGGTTAAGAAC-0	B_Naive
GTGTGCGTCTGCAAGT-0	B_Mem
GTGTTAGAGATGAGAG-0	B_Naive
GTGTTAGCAAACCCAT-0	B_Mem
GTGTTAGGTAAGTAGT-0	B_Naive
GTTAAGCAGACGCACA-0	B_Naive
GTTAAGCAGGGAGTAA-0	B_Naive
GTTACAGAGTTAGGTA-0	B_Naive
GTTCATTAGACACTAA-0	B_Naive
GTTCATTCAGGTCGTC-0	B_Mem
GTTCATTGTAAGTAGT-0	B_Naive
GTTCGGGTCAACCATG-0	B_Naive
GTTCTCGGTCGAACAG-0	B_Preplasma
GTTCTCGTCACTGGGC-0	B_Naive
GTTCTCGTCCTGTACC-0	B_Mem
GTTTCTACAGACGCCT-0	B_Naive
GTTTCTACATGCTGGC-0	B_Naive
GTTTCTAGTCTGATCA-0	B_Naive
TAAACCGAGATGCCTT-0	B_Naive
TAAACCGCATAGTAAG-0	B_Naive
TAAGAGACACTTAACG-0	B_Mem_Prolif
TAAGAGATCCGTTGCT-0	B_Naive
TAAGTGCAGTTCCACA-0	B_Naive
TACACGACAGGCTCAC-0	B_Naive
TACACGAGTTCGTTGA-0	B_Naive
TACACGATCAGCGACC-0	B_Naive
TACAGTGCAGATCTGT-0	B_Naive
TACAGTGTCGGACAAG-0	B_Naive
TACCTTAAGAGATGAG-0	B_Naive
TACGGATAGTCTCAAC-0	B_Naive
TACGGGCCATCACGTA-0	B_Preplasma
TACGGTAAGAGTCTGG-0	B_Preplasma
TACGGTAAGCCAACAG-0	B_Naive
TACGGTAGTCTCGTTC-0	B_Mem
TACTTACCAATGTTGC-0	B_Naive
TACTTACTCTGATTCT-0	B_Naive
TACTTGTAGCTAACTC-0	B_Naive
TACTTGTAGGCTATCT-0	B_Naive
TACTTGTCAAGTAATG-0	B_Naive
TACTTGTGTCTCACCT-0	B_Naive
TAGACCAAGTCATGCT-0	B_Naive
TAGACCACACAAGCCC-0	B_Preplasma
TAGACCAGTCGAGTTT-0	B_Mem
TAGCCGGAGGAACTGC-0	B_Preplasma
TAGCCGGCATTCTTAC-0	B_Mem
TAGCCGGGTGATGTGG-0	B_Naive
TAGGCATAGTCGTTTG-0	B_Preplasma
TAGTGGTAGAATAGGG-0	B_Naive
TAGTTGGAGTGAAGTT-0	B_Naive
TAGTTGGAGTTTGCGT-0	B_Naive
TATCTCAAGCAGATCG-0	B_Naive
TATCTCACAGGAATGC-0	B_Naive
TATCTCAGTCGCGTGT-0	B_Naive
TATGCCCTCATGTCTT-0	B_Naive
TATGCCCTCTTTACAC-0	B_Mem_Prolif
TATTACCAGCGGATCA-0	B_Naive
TATTACCGTCCCTTGT-0	B_Mem_Prolif
TATTACCTCAGGCAAG-0	B_Naive
TATTACCTCCGCAGTG-0	B_Preplasma
TATTACCTCGTTTATC-0	B_Naive
TATTACCTCTCAACTT-0	B_Naive
TCAATCTCATGAGCGA-0	B_Preplasma
TCAATCTTCTAGAGTC-0	B_Naive
TCACAAGAGACACTAA-0	B_Mem_Prolif
TCACAAGAGCCCAGCT-0	B_Naive
TCACAAGAGGCGCTCT-0	B_Naive
TCACAAGAGTTGTAGA-0	B_Mem_Prolif
TCACAAGCAAAGTGCG-0	B_Naive
TCACGAAAGAATAGGG-0	B_Naive
TCACGAACAGCTTAAC-0	B_Mem_Prolif
TCACGAACAGTGACAG-0	B_Naive
TCAGCAAAGGCCCTTG-0	B_Naive
TCAGCAATCCGTTGCT-0	B_Naive
TCAGCAATCCTTGGTC-0	B_Naive
TCAGCTCCAGGTCTCG-0	B_Mem_Prolif
TCAGCTCCATCACGTA-0	B_Naive
TCAGCTCGTCGCTTCT-0	B_Naive
TCAGCTCTCAAACGGG-0	B_Naive
TCAGGTAAGGTCATCT-0	B_Naive
TCATTACAGTCAAGCG-0	B_Naive
TCATTACCACCATGTA-0	B_Mem
TCATTACCACGCTTTC-0	B_Mem
TCATTACTCCATTCTA-0	B_Naive
TCATTTGCATCCCATC-0	B_Naive
TCCACACAGGTAAACT-0	B_Naive
TCCACACAGTCACGCC-0	B_Naive
TCCACACGTATTAGCC-0	B_Naive
TCCACACGTCCTCCAT-0	B_Naive
TCCACACTCAACGAAA-0	B_Naive
TCCCGATTCACAATGC-0	B_Naive
TCGAGGCGTACGACCC-0	B_Naive
TCGAGGCGTCCTCTTG-0	B_Naive
TCGAGGCGTCTAGAGG-0	B_Naive
TCGCGTTTCATTTGGG-0	B_Naive
TCGGGACGTGGAAAGA-0	B_Mem
TCGGGACTCGTGGTCG-0	B_Naive
TCGGTAATCATGCATG-0	B_Mem_Prolif
TCGGTAATCGTCTGCT-0	B_Naive
TCGTAGACAGTCAGCC-0	B_Naive
TCTATTGAGAAACCTA-0	B_Preplasma
TCTATTGCAGGAATCG-0	B_Naive
TCTCATACACCACGTG-0	B_Naive
TCTCTAACACGGACAA-0	B_Preplasma
TCTCTAACAGCCAATT-0	B_Naive
TCTCTAAGTGATGCCC-0	B_Naive
TCTGAGAGTACCCAAT-0	B_Mem_Prolif
TCTGGAAAGCATCATC-0	B_Naive
TCTGGAACACCCATGG-0	B_Naive
TCTTCGGCAAGCCGCT-0	B_Mem
TCTTCGGGTTACGGAG-0	B_Naive
TCTTTCCAGCAATATG-0	B_Naive
TCTTTCCAGGACCACA-0	B_Naive
TGACGGCAGTCTCAAC-0	B_Mem
TGACTAGAGAGCTATA-0	B_Naive
TGACTAGAGAGGGCTT-0	B_Naive
TGACTAGAGCGTTCCG-0	B_Naive
TGACTAGTCAGTTGAC-0	B_Naive
TGACTAGTCTAACTTC-0	B_Naive
TGACTTTAGCACCGTC-0	B_Preplasma
TGACTTTCAGACTCGC-0	B_Naive
TGACTTTGTGTAATGA-0	B_Naive
TGACTTTGTTCAGACT-0	B_Naive
TGAGCATAGATCCTGT-0	B_Mem
TGAGCATGTCGATTGT-0	B_Naive
TGAGCATGTCTGCGGT-0	B_Naive
TGAGCCGTCACTGGGC-0	B_Naive
TGAGCCGTCTGATTCT-0	B_Naive
TGAGGGAAGCAATCTC-0	B_Mem
TGAGGGAGTCGTTGTA-0	B_Mem
TGAGGGATCATCTGCC-0	B_Preplasma
TGATTTCTCACGCATA-0	B_Naive
TGCACCTGTGCACGAA-0	B_Naive
TGCACCTTCTTGAGAC-0	B_Naive
TGCCAAAAGCCAGAAC-0	B_Naive
TGCCAAAGTCAGTGGA-0	B_Naive
TGCCAAAGTGACTACT-0	B_Preplasma
TGCCAAAGTGTAACGG-0	B_Naive
TGCCCTACAATCGGTT-0	B_Naive
TGCCCTATCTTGCCGT-0	B_Mem_Prolif
TGCGCAGCATGTCTCC-0	B_Mem_Prolif
TGCGCAGTCTCTGCTG-0	B_Mem_Prolif
TGCGGGTAGAAGCCCA-0	B_Naive
TGCGGGTAGAGCAATT-0	B_Naive
TGCGGGTAGGCATTGG-0	B_Naive
TGCGGGTAGTGACATA-0	B_Naive
TGCGGGTGTCATATGC-0	B_Naive
TGCGGGTGTTCCAACA-0	B_Naive
TGCGGGTTCGTGACAT-0	B_Naive
TGCGTGGAGATGAGAG-0	B_Naive
TGCGTGGGTCTCACCT-0	B_Mem_Prolif
TGCGTGGGTTACGTCA-0	B_Naive
TGCTGCTAGGTGTGGT-0	B_Naive
TGCTGCTCAGACAAGC-0	B_Naive
TGCTGCTCATCCCACT-0	B_Naive
TGGCGCAGTAAGGATT-0	B_Preplasma
TGGCGCATCAACGGCC-0	B_Preplasma
TGGCGCATCCTATGTT-0	B_Naive
TGGCTGGTCATGTGGT-0	B_Mem
TGGGAAGGTCGCATCG-0	B_Naive
TGGGCGTCAGCATGAG-0	B_Naive
TGGGCGTCAGCCAATT-0	B_Naive
TGGGCGTGTCCATGAT-0	B_Mem_Prolif
TGGTTAGCAGCCTGTG-0	B_Naive
TGGTTCCGTACCGTAT-0	B_Naive
TGGTTCCGTCGAACAG-0	B_Naive
TGTATTCAGGTTACCT-0	B_Mem
TGTATTCAGTTCGATC-0	B_Naive
TGTCCCATCATCACCC-0	B_Mem_Prolif
TGTGGTACATACGCTA-0	B_Naive
TGTTCCGGTCTAGCCG-0	B_Naive
TGTTCCGGTGGCTCCA-0	B_Mem_Prolif
TTAACTCCACCACCAG-0	B_Naive
TTAACTCGTTCCACAA-0	B_Preplasma
TTAGGACCACAAGACG-0	B_Naive
TTAGGACGTAGATTAG-0	B_Naive
TTAGGACGTGCACGAA-0	B_Mem
TTAGGCAAGATCCCGC-0	B_Naive
TTAGGCAGTAATAGCA-0	B_Preplasma
TTAGGCAGTAGCGTAG-0	B_Preplasma
TTAGTTCCACTATCTT-0	B_Naive
TTAGTTCGTCTCTCGT-0	B_Naive
TTAGTTCTCTATCCCG-0	B_Preplasma
TTATGCTCAACTGCGC-0	B_Mem_Prolif
TTCCCAGTCAGTTCGA-0	B_Naive
TTCCCAGTCTGTCTAT-0	B_Naive
TTCGAAGGTCATATCG-0	B_Naive
TTCGGTCAGAGGTAGA-0	B_Mem
TTCTACAAGAGGTAGA-0	B_Mem
TTCTACAGTCCAGTTA-0	B_Naive
TTCTACATCACGACTA-0	B_Naive
TTCTCAACATCTCGCT-0	B_Naive
TTCTCCTTCCGCATCT-0	B_Naive
TTGAACGTCAGCACAT-0	B_Naive
TTGACTTAGGCTCATT-0	B_Naive
TTGACTTGTGCACGAA-0	B_Naive
TTGCCGTAGCTAGTGG-0	B_Mem
TTGCCGTGTCCTCTTG-0	B_Preplasma
TTGCCGTTCCAAACAC-0	B_Mem
TTGGAACCAGGTCCAC-0	B_Mem
TTGGAACGTGAACCTT-0	B_Naive
TTGGCAAAGATGTGTA-0	B_Preplasma
TTGGCAAAGGGCTTGA-0	B_Naive
TTGTAGGGTTGGACCC-0	B_Preplasma
TTGTAGGTCTTGACGA-0	B_Naive
TTTACTGAGAAACCTA-0	B_Naive
TTTACTGGTGATAAGT-0	B_Naive
TTTATGCGTTGTCTTT-0	B_Naive
TTTATGCTCCGATATG-0	B_Naive
TTTCCTCAGCACCGCT-0	B_Naive
TTTCCTCAGTACGCGA-0	B_Mem
TTTGCGCAGCTTATCG-0	B_Mem_Prolif
TTTGCGCCACACGCTG-0	B_Naive
TTTGCGCCACGGCCAT-0	B_Naive
TTTGTCAGTTCACCTC-0	B_Mem_Prolif
TTTGTCATCAGGCGAA-0	B_Naive
