AAACCTGGTAGTGAAT	T8_Mem
AAACGGGAGTCGCCGT	T8_Mem
AAAGATGCATGTAGTC	T8_Naive
AAAGATGGTGGTTTCA	T8_Naive
AAAGATGTCCAGTATG	T8_Mem
AAAGCAAAGCTCAACT	T8_Naive
AAAGCAAAGGTAAACT	T8_Mem
AAAGCAACACTCGACG	T8_MAIT
AAAGCAACAGCTGTTA	T8_Mem
AAAGCAAGTATGGTTC	T8_Mem
AAAGCAAGTGGACGAT	T8_Mem
AAAGTAGGTACAGCAG	T8_Mem
AAATGCCAGCCACCTG	T8_Mem
AAATGCCAGCTCTCGG	T8_MAIT
AAATGCCGTCCGTCAG	T8_Mem
AAATGCCTCGGCCGAT	T8_Mem
AACACGTCAATGGAGC	T8_Mem
AACACGTTCACTTACT	T8_Mem
AACCATGCATGTCGAT	T8_Mem
AACCATGGTTCCCGAG	T8_Mem
AACCATGTCAGCATGT	T8_Mem
AACCGCGGTTCCATGA	T8_Mem
AACGTTGAGACACGAC	T8_Naive
AACGTTGAGTGGACGT	T8_Mem
AACGTTGCAGCTCGAC	T8_Naive
AACGTTGCAGGGTTAG	T8_Mem
AACGTTGGTAGCGTAG	T8_Mem
AACGTTGGTGGACGAT	T8_Naive
AACTCAGCATCACGAT	T8_Mem
AACTCCCGTGCCTTGG	T8_Mem
AACTCCCGTTTGTTGG	T8_Mem
AACTCTTAGCGCTTAT	T8_Mem
AACTCTTCATAGAAAC	T8_Mem
AACTCTTGTTACGACT	T8_MAIT
AACTCTTGTTGAACTC	T8_Naive
AACTCTTGTTGGGACA	T8_Naive
AACTCTTTCACAAACC	T8_Mem
AACTGGTCAGCTCGCA	T8_Mem
AACTGGTGTACCGTTA	T8_Naive
AACTGGTGTCACTGGC	T8_Naive
AACTGGTTCAGTTTGG	T8_Mem
AACTTTCAGCGATCCC	T8_Mem
AACTTTCCAGCCAGAA	T8_Naive
AACTTTCGTAAAGGAG	T8_Mem
AAGACCTAGAGTAATC	T8_Naive
AAGACCTAGCCGTCGT	T8_Mem
AAGACCTTCAAAGTAG	T8_Mem
AAGACCTTCTGAAAGA	T8_Mem
AAGACCTTCTGTCTAT	T8_Naive
AAGACCTTCTGTTTGT	T8_Mem
AAGCCGCAGACTCGGA	T8_Mem
AAGCCGCAGTGTTGAA	T8_Mem
AAGCCGCGTACAGTGG	T8_Mem
AAGCCGCGTGAAATCA	T8_Naive
AAGGAGCAGTGAAGAG	T8_Mem
AAGGAGCCAGTGACAG	T8_Naive
AAGGAGCTCACGAAGG	T8_MAIT
AAGGAGCTCCCTCAGT	T8_Mem
AAGGAGCTCCTCGCAT	T8_Mem
AAGGTTCAGACTAAGT	T8_Mem
AAGGTTCAGTGGTCCC	T8_Mem
AAGTCTGAGCCAACAG	T8_Mem
AAGTCTGGTGGCCCTA	T8_Mem
AATCCAGCAAGTACCT	T8_Mem
AATCGGTGTAAAGTCA	T8_Mem
AATCGGTTCAGTACGT	T8_Mem
ACACCAAAGGCGCTCT	T8_Naive
ACACCAACACCAGTTA	T8_Naive
ACACCAAGTGATGTGG	T8_Naive
ACACCAAGTTCCCGAG	T8_Mem
ACACCCTCAAGCTGAG	T8_Mem
ACACCCTCATAGTAAG	T8_Naive
ACACCCTTCTCTAGGA	T8_Naive
ACACCGGAGGACCACA	T8_Mem
ACACCGGGTAATCACC	T8_Mem
ACACTGAAGACTGGGT	T8_Mem
ACACTGACAAGCGTAG	T8_Mem
ACACTGAGTGGTTTCA	T8_Mem
ACAGCCGAGTACGCGA	T8_Mem
ACAGCCGCAAGCCTAT	T8_Mem
ACAGCCGGTACCTACA	T8_Mem
ACAGCCGTCACGAAGG	T8_Naive
ACAGCCGTCGTAGGTT	T8_Naive
ACAGCTAAGACAATAC	T8_Mem
ACAGCTAAGGTCATCT	T8_Mem
ACAGCTAAGTAAGTAC	T8_Mem
ACAGCTACAGCGTAAG	T8_Mem
ACAGCTATCCGCAGTG	T8_Mem
ACATACGCAGCCAATT	T8_Naive
ACATACGCATCCGGGT	T8_Mem
ACATACGGTTGGGACA	T8_Mem
ACATCAGAGTGTGAAT	T8_Mem
ACATCAGGTCGCGAAA	T8_Mem
ACATGGTAGGGATACC	T8_Naive
ACATGGTCACGGATAG	T8_Naive
ACATGGTGTAGCTAAA	T8_Mem
ACATGGTGTGCACTTA	T8_Mem
ACCAGTACACGTGAGA	T8_Mem
ACCAGTAGTGATAAAC	T8_Mem
ACCAGTATCACCGTAA	T8_Mem_Prolif
ACCCACTCAGGGTTAG	T8_Mem
ACCCACTCATGTAGTC	T8_Naive
ACCCACTGTAGGGACT	T8_Mem
ACCGTAAAGAACTCGG	T8_Mem
ACCGTAACACATGACT	T8_Mem
ACCGTAACATTAGGCT	T8_Mem
ACCGTAAGTCAACATC	T8_Naive
ACCGTAAGTCCCTACT	T8_Mem
ACCTTTAAGCGCCTTG	T8_Mem
ACCTTTACACAACTGT	T8_Mem
ACCTTTACAGGGCATA	T8_Mem
ACCTTTAGTGGTGTAG	T8_Mem
ACCTTTATCAACCATG	T8_Naive
ACCTTTATCTGTCCGT	T8_Naive
ACGAGCCCAAGAAAGG	T8_Naive
ACGAGCCCATTAGCCA	T8_Mem
ACGAGGACACGAAAGC	T8_Mem
ACGAGGATCACGACTA	T8_Naive
ACGAGGATCTCGTTTA	T8_Mem
ACGATACAGATGCGAC	T8_Naive
ACGATACAGGAATTAC	T8_Mem
ACGATACAGGGTTCCC	T8_Mem
ACGATACGTAAACACA	T8_Mem
ACGATACGTCCCGACA	T8_Mem
ACGATACGTCTTCAAG	T8_Mem
ACGATACTCAGTCCCT	T8_Naive
ACGATGTGTCACACGC	T8_Naive
ACGCAGCCAACTGCGC	T8_Naive
ACGCCAGAGAACAATC	T8_Mem
ACGCCAGAGCGTAATA	T8_Naive
ACGCCAGAGCTGAACG	T8_Mem
ACGCCAGAGTGCTGCC	T8_Naive
ACGCCAGCACCCAGTG	T8_Mem
ACGCCAGCACCGGAAA	T8_Mem_Prolif
ACGCCAGCAGCCAATT	T8_Mem
ACGCCAGCAGGCAGTA	T8_Naive
ACGCCAGGTTCTCATT	T8_Mem
ACGCCAGTCGCAAACT	T8_Mem
ACGCCGAAGCAGACTG	T8_Mem
ACGCCGAAGTACACCT	T8_Mem
ACGGAGAGTACTTAGC	T8_Mem
ACGGCCAAGCCTCGTG	T8_Mem_Prolif
ACGGCCAAGCTGTTCA	T8_Mem
ACGGCCAAGGTGCAAC	T8_Mem
ACGGCCAGTGTGCCTG	T8_Mem
ACGGCCATCAGAAATG	T8_Mem
ACGGCCATCAGCTCGG	T8_Mem
ACGGGCTAGAGGTACC	T8_Naive
ACGGGCTCACCGAAAG	T8_Naive
ACGGGCTGTGCCTGGT	T8_Mem
ACGGGCTTCGTACCGG	T8_Mem
ACGGGTCAGGGAAACA	T8_Naive
ACGGGTCCAAGTAGTA	T8_Mem
ACGGGTCCATCACCCT	T8_Mem
ACGGGTCGTCCAGTTA	T8_Mem
ACGGGTCGTCTTCAAG	T8_Naive
ACGGGTCTCCTTGACC	T8_Naive
ACGTCAAAGTCTCAAC	T8_Mem
ACGTCAACATGCCCGA	T8_MAIT
ACGTCAAGTAAGGGCT	T8_Naive
ACGTCAAGTCTGCAAT	T8_Naive
ACGTCAATCACGACTA	T8_Mem
ACTATCTAGAGTCTGG	T8_Mem
ACTATCTGTCAGAAGC	T8_Mem
ACTATCTGTCGACTGC	T8_Mem
ACTATCTTCTGATACG	T8_Mem
ACTGAACGTAGCCTCG	T8_Mem
ACTGAACTCCAAGCCG	T8_Mem
ACTGAGTAGACTTGAA	T8_Naive
ACTGAGTAGAGCTGGT	T8_Mem
ACTGAGTAGGGAACGG	T8_MAIT
ACTGAGTCAGCTATTG	T8_Mem
ACTGAGTCATTCGACA	T8_Mem
ACTGAGTTCGGCCGAT	T8_Mem
ACTGAGTTCGTCTGAA	T8_Naive
ACTGAGTTCTTACCGC	T8_Naive
ACTGATGCAGGTGGAT	T8_Mem
ACTGATGCATCTCGCT	T8_Mem
ACTGATGTCCAGTATG	T8_Mem
ACTGATGTCCGAAGAG	T8_Mem
ACTGCTCAGATATGGT	T8_Mem
ACTGCTCCAATGAAAC	T8_Mem
ACTGCTCCACTATCTT	T8_Mem
ACTGCTCCATGACATC	T8_Mem
ACTGCTCGTGCCTTGG	T8_Mem
ACTGTCCCAGATGGCA	T8_Mem
ACTTACTCACAGGTTT	T8_Mem
ACTTACTCACGGTAGA	T8_Mem
ACTTACTCAGGAATGC	T8_MAIT
ACTTGTTCAGGGTATG	T8_Naive
ACTTGTTCATCGATGT	T8_Mem
ACTTGTTGTACTCGCG	T8_Mem_Prolif
ACTTGTTTCATCTGTT	T8_Naive
ACTTGTTTCTTGGGTA	T8_Mem
ACTTTCAAGACAAGCC	T8_Naive
ACTTTCAGTCCCTTGT	T8_Naive
ACTTTCAGTCTAGCGC	T8_MAIT
AGACGTTCACCACGTG	T8_Mem
AGACGTTCAGAGTGTG	T8_Mem
AGACGTTGTTCCAACA	T8_MAIT
AGAGCTTAGAGCTGCA	T8_Mem
AGAGCTTAGCAGACTG	T8_Mem
AGAGCTTCAATGAATG	T8_Naive
AGAGTGGAGATCGATA	T8_Mem
AGAGTGGGTCAAACTC	T8_Mem_Prolif
AGAGTGGGTGTATGGG	T8_Naive
AGAGTGGTCGTCTGAA	T8_Mem
AGATCTGCACGGTTTA	T8_Naive
AGATCTGCAGAAGCAC	T8_Mem
AGATTGCAGCGTAATA	T8_Mem
AGATTGCAGTAACCCT	T8_Mem
AGATTGCAGTAGATGT	T8_Mem
AGATTGCGTCAAAGCG	T8_Mem
AGATTGCGTCATTAGC	T8_Mem
AGATTGCTCACCAGGC	T8_Mem
AGCAGCCGTATCTGCA	T8_Mem
AGCATACAGCTAGGCA	T8_Naive
AGCATACGTTAGGGTG	T8_Mem
AGCGGTCCACATCCGG	T8_Mem
AGCGGTCCAGACACTT	T8_Mem
AGCGGTCCAGCTGCTG	T8_Naive
AGCGGTCGTCAGCTAT	T8_Mem
AGCGGTCTCTTGCAAG	T8_Mem
AGCGTATAGTAGATGT	T8_Mem
AGCTCCTCAAGCGTAG	T8_Naive
AGCTCCTGTACAGTTC	T8_Mem
AGCTCCTGTCCAAGTT	T8_Mem
AGCTCCTGTGCAACGA	T8_Mem
AGCTCTCTCTGCTGTC	T8_Mem
AGCTTGAAGATGCCAG	T8_Mem
AGCTTGACAAGTAGTA	T8_Mem
AGCTTGAGTAACGTTC	T8_Mem
AGCTTGAGTGAGGCTA	T8_Naive
AGCTTGAGTTGGAGGT	T8_Naive
AGCTTGATCAACACTG	T8_Mem_Prolif
AGGCCACAGACTAGAT	T8_Mem
AGGCCACAGTAACCCT	T8_Mem
AGGCCACCACATTTCT	T8_Mem
AGGCCACCAGGTTTCA	T8_Mem
AGGCCACCATATACGC	T8_Mem
AGGCCGTAGCGTCTAT	T8_Naive
AGGCCGTCACCTATCC	T8_Mem
AGGCCGTGTCAATACC	T8_Mem
AGGCCGTGTCGCGTGT	T8_Mem
AGGGAGTCAAGTAATG	T8_Naive
AGGGAGTGTTGCGCAC	T8_Naive
AGGGATGAGGCCCGTT	T8_Mem
AGGGATGCACCAGATT	T8_Mem
AGGGATGTCAGAAATG	T8_Mem
AGGGATGTCGGTCCGA	T8_Mem
AGGGTGAAGAAGGGTA	T8_Mem_Prolif
AGGGTGAAGCTGGAAC	T8_Mem
AGGTCATAGCTAGCCC	T8_Mem
AGGTCATGTCAGGACA	T8_Mem
AGGTCCGGTCGCATCG	T8_Mem
AGTAGTCCACAGATTC	T8_Naive
AGTAGTCGTAATCACC	T8_Mem
AGTAGTCGTTAAGAAC	T8_Mem
AGTCTTTAGCAAATCA	T8_Mem
AGTCTTTCAATCAGAA	T8_Mem
AGTCTTTGTACCGTAT	T8_Mem
AGTCTTTGTACTTGAC	T8_Mem
AGTGAGGAGAGCTTCT	T8_Naive
AGTGAGGTCGTACGGC	T8_Mem
AGTGGGAAGCCCAGCT	T8_Mem
AGTGGGATCACCTTAT	T8_Mem
AGTGGGATCGCCAAAT	T8_Naive
AGTGTCAAGACTAAGT	T8_Mem
AGTGTCAAGGGATCTG	T8_Mem
AGTGTCATCGGCATCG	T8_Mem
AGTGTCATCGGTCCGA	T8_Mem
AGTTGGTTCTATCGCC	T8_Mem
ATAACGCAGCGATATA	T8_Mem
ATAAGAGAGAGAGCTC	T8_Mem
ATAGACCAGGATATAC	T8_Naive
ATAGACCGTAAGGGCT	T8_Mem_Prolif
ATAGACCGTGCTCTTC	T8_Mem
ATCACGAAGCTAGTCT	T8_Mem
ATCACGACAAGTCATC	T8_Mem_Prolif
ATCACGACAGTCTTCC	T8_Mem
ATCACGAGTCAAGCGA	T8_Naive
ATCACGAGTGTTGAGG	T8_Mem
ATCACGAGTTAGAACA	T8_Naive
ATCACGATCCGGCACA	T8_Mem
ATCATCTGTACAGACG	T8_Naive
ATCATCTGTTAGATGA	T8_Mem
ATCATCTTCGAGAACG	T8_Mem
ATCATGGAGTGTTGAA	T8_Mem
ATCATGGCAGCCTTTC	T8_Mem
ATCATGGGTTAAGACA	T8_Naive
ATCATGGTCAGGCAAG	T8_Mem
ATCATGGTCCTTTCTC	T8_Mem
ATCCACCTCCAAGCCG	T8_Mem_Prolif
ATCCGAAAGTAGGCCA	T8_Mem
ATCCGAACAAACGTGG	T8_Naive
ATCCGAACATGCTGGC	T8_Naive
ATCGAGTAGAATTCCC	T8_Mem
ATCGAGTAGCTCCTTC	T8_Mem
ATCGAGTAGTGTGAAT	T8_Mem_Prolif
ATCGAGTAGTTAACGA	T8_Naive
ATCGAGTCAATTGCTG	T8_Mem
ATCGAGTGTAGAGCTG	T8_Mem
ATCGAGTGTGGGTCAA	T8_Mem
ATCGAGTTCTCGGACG	T8_Mem
ATCTACTAGAGCTGCA	T8_Mem
ATCTACTAGGCAATTA	T8_Mem
ATCTACTGTCTCCCTA	T8_Mem
ATCTGCCTCGGCATCG	T8_Mem
ATGAGGGCAAGCCGCT	T8_Mem
ATGAGGGTCTCTGAGA	T8_Mem
ATGCGATTCAGCGACC	T8_Naive
ATGCGATTCTGTCCGT	T8_Naive
ATGGGAGAGCTACCGC	T8_Mem
ATGGGAGAGGGTGTTG	T8_Mem
ATGGGAGTCGCCAGCA	T8_Naive
ATGTGTGAGATACACA	T8_Naive
ATGTGTGAGCATGGCA	T8_Mem
ATGTGTGTCACAATGC	T8_Mem
ATGTGTGTCACAGGCC	T8_Naive
ATTACTCAGACGCACA	T8_Naive
ATTACTCCAAGCGATG	T8_Naive
ATTACTCTCGTTTAGG	T8_Mem
ATTATCCAGTACGTAA	T8_Naive
ATTATCCGTCAGAATA	T8_Mem
ATTATCCGTGGAAAGA	T8_Mem
ATTCTACAGCGCTCCA	T8_Mem
ATTCTACCATGCTAGT	T8_Mem
ATTCTACCATTAGCCA	T8_Naive
ATTCTACTCATCATTC	T8_Mem
ATTCTACTCCCTCTTT	T8_Mem
ATTCTACTCCTGCTTG	T8_Mem
ATTGGACCACTGAAGG	T8_Naive
ATTGGACCAGGAATCG	T8_Mem
ATTGGTGCAAGGGTCA	T8_Mem
ATTTCTGAGGTGTGGT	T8_Naive
ATTTCTGAGTCCTCCT	T8_Mem
ATTTCTGGTAATCGTC	T8_Mem
ATTTCTGGTCTCTTAT	T8_Mem
ATTTCTGGTTCGCTAA	T8_Mem
CAACCAACACCTATCC	T8_Mem
CAACCAAGTGGCTCCA	T8_Mem
CAACCAATCTTGTCAT	T8_Naive
CAACCTCAGAAGGCCT	T8_Naive
CAACCTCGTCCTGCTT	T8_Mem
CAACCTCTCGAGCCCA	T8_Mem
CAACCTCTCTGCAAGT	T8_Mem
CAACTAGAGCGTGAGT	T8_Mem
CAACTAGCACAGCGTC	T8_Mem
CAACTAGGTACCGTTA	T8_Mem
CAACTAGTCAACCAAC	T8_Mem
CAACTAGTCTCGCTTG	T8_Mem
CAACTAGTCTTATCTG	T8_Naive
CAAGATCCAGCTGCTG	T8_Mem
CAAGATCTCAGCAACT	T8_Mem
CAAGATCTCCTAGAAC	T8_Mem
CAAGGCCAGGCATGGT	T8_Naive
CAAGGCCTCCGGCACA	T8_Mem
CAAGTTGAGAAGAAGC	T8_Mem
CAAGTTGAGGCATGGT	T8_Mem
CAAGTTGCAACACCTA	T8_Naive
CAAGTTGCAAGACGTG	T8_Mem
CAAGTTGGTCACACGC	T8_Mem
CAAGTTGGTCACCTAA	T8_Naive
CACAAACAGAGTACCG	T8_Mem
CACAAACCACAGGCCT	T8_Naive
CACAAACGTAAGGATT	T8_Naive
CACACAACACCACGTG	T8_Mem
CACACAACACGGACAA	T8_Mem
CACACAAGTACTTAGC	T8_Mem
CACACAAGTCGTGGCT	T8_Mem
CACACAAGTGCTGTAT	T8_Naive
CACACAAGTTCCCGAG	T8_Mem
CACACAATCACGACTA	T8_Mem
CACACCTCACCACCAG	T8_MAIT
CACACCTCACTAAGTC	T8_Naive
CACACCTTCTGGTGTA	T8_Mem
CACACTCCAAGTTAAG	T8_Mem_Prolif
CACACTCCAGGACGTA	T8_Mem
CACACTCCAGTCGATT	T8_Mem
CACAGGCAGTAATCCC	T8_Mem
CACAGGCCACCTGGTG	T8_Mem
CACAGGCGTTCAGCGC	T8_Mem
CACAGGCGTTCCGGCA	T8_Mem
CACAGGCGTTCGGCAC	T8_Naive
CACATAGAGGTACTCT	T8_Mem
CACATAGCACCAGGCT	T8_Mem_Prolif
CACATAGTCGGAATCT	T8_Naive
CACATTTCAAGTTCTG	T8_Mem
CACATTTGTATAATGG	T8_Mem
CACATTTGTTCAGACT	T8_Naive
CACCACTGTCCATGAT	T8_Mem
CACCACTGTCGCATCG	T8_Mem
CACCAGGTCACCGGGT	T8_Mem
CACCTTGTCCTAAGTG	T8_Mem
CACTCCAAGTCATCCA	T8_Mem
CACTCCAGTCCGTCAG	T8_Naive
CACTCCATCCATTCTA	T8_Mem
CACTCCATCTCCAGGG	T8_Mem
CAGAATCAGCAGCCTC	T8_Mem
CAGAATCCATCTACGA	T8_Mem
CAGAATCGTATGAATG	T8_Mem
CAGAATCTCCCACTTG	T8_Mem
CAGAGAGAGAAACCTA	T8_Mem
CAGAGAGAGGTGTTAA	T8_Naive
CAGAGAGGTACATCCA	T8_Mem
CAGAGAGTCAGCCTAA	T8_Mem
CAGATCAAGAGTCTGG	T8_Mem_Prolif
CAGCAGCAGCAATATG	T8_Mem
CAGCAGCAGCAGGCTA	T8_Naive
CAGCAGCAGGCGCTCT	T8_Mem
CAGCAGCCACAGTCGC	T8_Mem
CAGCAGCTCAAGATCC	T8_Mem
CAGCAGCTCGAGCCCA	T8_Mem
CAGCATAAGAGGACGG	T8_Mem
CAGCATAAGGATTCGG	T8_Naive
CAGCATAAGTCATCCA	T8_Mem
CAGCATAGTCTCTCTG	T8_Mem
CAGCATAGTGAACCTT	T8_Mem
CAGCCGACATTACCTT	T8_Mem
CAGCCGAGTGCTCTTC	T8_Mem
CAGCCGATCTAAGCCA	T8_Mem
CAGCCGATCTCGATGA	T8_Mem
CAGCCGATCTTGTACT	T8_Mem
CAGCTAAAGGGATACC	T8_Naive
CAGCTAACACAGATTC	T8_Mem
CAGCTAAGTGAAAGAG	T8_Mem
CAGCTAATCCTTAATC	T8_Mem
CAGCTAATCTTTACAC	T8_Naive
CAGCTGGCACAACGTT	T8_Naive
CAGCTGGCAGACACTT	T8_Mem
CAGCTGGGTAGGCATG	T8_Mem
CAGCTGGGTCTGATCA	T8_Mem
CAGCTGGGTGCACCAC	T8_Mem
CAGCTGGTCCGGGTGT	T8_Mem
CAGGTGCAGAGGTTGC	T8_Mem
CAGGTGCAGGATGGAA	T8_Mem
CAGGTGCCACGGATAG	T8_Naive
CAGGTGCGTCCGTGAC	T8_Mem
CAGTAACCATGTTGAC	T8_Mem
CAGTAACCATTCTCAT	T8_Mem
CAGTCCTAGCTCCTCT	T8_Naive
CAGTCCTCACAAGTAA	T8_Mem
CATATGGGTCAAAGAT	T8_Mem
CATATTCAGGCATTGG	T8_Naive
CATCAGAAGGGAAACA	T8_Mem
CATCAGACACTGAAGG	T8_Mem
CATCAGAGTAAGGGCT	T8_Mem
CATCAGAGTGAAAGAG	T8_Mem_Prolif
CATCAGATCCGCGTTT	T8_Mem
CATCAGATCGGTTCGG	T8_Mem
CATCCACAGCCAGGAT	T8_Mem
CATCGAATCAACGCTA	T8_Mem
CATCGGGAGAGTAAGG	T8_Mem
CATGACAAGCGATGAC	T8_Naive
CATGACACAAGCGTAG	T8_Naive
CATGCCTAGATGCCTT	T8_Mem
CATGCCTCACTACAGT	T8_Mem
CATGCCTCAGTGGGAT	T8_Mem
CATGGCGTCACTTCAT	T8_Naive
CATTATCAGTTATCGC	T8_Naive
CATTATCGTAGGGACT	T8_MAIT
CATTATCGTGAAAGAG	T8_Naive
CATTCGCGTCCGTTAA	T8_Naive
CCAATCCAGAGTAAGG	T8_Naive
CCAATCCCAGCTGCTG	T8_Mem_Prolif
CCACCTAAGGGTCTCC	T8_Naive
CCACGGAAGACTAGGC	T8_Naive
CCACGGACAGGCTGAA	T8_Mem
CCACGGAGTCAGAATA	T8_Mem
CCACGGAGTCGGCTCA	T8_Mem
CCACGGAGTGATGATA	T8_Mem
CCACGGATCTTCGAGA	T8_Mem
CCACTACGTTGATTGC	T8_Mem
CCACTACTCGAGAGCA	T8_Naive
CCACTACTCTGCTTGC	T8_Naive
CCAGCGACACGAAGCA	T8_Mem
CCATGTCAGATCCCGC	T8_Mem
CCATGTCAGTCGTACT	T8_Mem
CCATGTCTCATACGGT	T8_Naive
CCATTCGAGTCCGGTC	T8_Mem
CCATTCGAGTGCCAGA	T8_MAIT
CCATTCGCATGCCACG	T8_Mem
CCATTCGGTCGTTGTA	T8_Mem
CCCAATCAGTACGTTC	T8_Mem
CCCAATCAGTGTCCAT	T8_Naive
CCCAATCCACGGTTTA	T8_Mem
CCCAATCGTAGCAAAT	T8_Mem_Prolif
CCCAATCTCGGCCGAT	T8_Mem
CCCAGTTGTTTGTTGG	T8_Mem
CCCAGTTTCTACTCAT	T8_Naive
CCCATACTCTTGGGTA	T8_Naive
CCCTCCTAGTTGAGTA	T8_Naive
CCCTCCTTCAGCTGGC	T8_Naive
CCGGGATCACCCAGTG	T8_Mem
CCGGGATCACTTAACG	T8_MAIT
CCGGGATCAGCCTTGG	T8_Naive
CCGGGATGTAGGCATG	T8_Mem
CCGGGATGTATTAGCC	T8_Naive
CCGGGATGTCATTAGC	T8_Naive
CCGGGATGTGACGGTA	T8_MAIT
CCGGTAGGTAAAGGAG	T8_Naive
CCGTACTCAGGCAGTA	T8_Mem
CCGTGGAAGGGCTTCC	T8_Mem_Prolif
CCGTGGACACTTAACG	T8_Naive
CCGTGGAGTCCTCCAT	T8_Mem
CCGTGGAGTGTCAATC	T8_Naive
CCGTTCACAGGTCTCG	T8_Mem
CCGTTCAGTTGGTTTG	T8_Mem
CCGTTCATCAGAAATG	T8_Naive
CCTAAAGAGACTAGAT	T8_Mem
CCTAAAGCACCGAATT	T8_MAIT
CCTAAAGGTAAGAGGA	T8_Mem_Prolif
CCTAAAGGTATTAGCC	T8_Mem
CCTAAAGGTGACAAAT	T8_Mem
CCTAAAGTCGCCTGAG	T8_Mem
CCTAAAGTCTTACCTA	T8_Mem
CCTACACAGAAACGCC	T8_Mem
CCTACACAGCGATCCC	T8_Naive
CCTACACGTCTTGTCC	T8_MAIT
CCTACACGTTAGATGA	T8_Mem
CCTACCAAGTAGGCCA	T8_Mem
CCTACCACATACAGCT	T8_Naive
CCTACCAGTCCGTTAA	T8_Mem
CCTAGCTCACGCTTTC	T8_Naive
CCTATTATCAATAAGG	T8_Mem
CCTATTATCACAATGC	T8_Naive
CCTCAGTCATCAGTCA	T8_Mem
CCTCAGTGTGAGGCTA	T8_Mem
CCTCAGTGTTACCAGT	T8_Mem
CCTCTGAAGAAGGTGA	T8_Mem
CCTCTGACAACTGCTA	T8_Mem
CCTCTGACAATAGCAA	T8_Mem_Prolif
CCTCTGACACCTCGTT	T8_Naive
CCTCTGAGTTCAGTAC	T8_MAIT
CCTTACGAGCTGGAAC	T8_Mem
CCTTCCCCAGCCAATT	T8_Mem
CCTTCCCGTGGTGTAG	T8_Naive
CCTTCGACACTTCTGC	T8_Mem
CCTTCGAGTTCCCTTG	T8_Mem
CCTTCGATCGTGACAT	T8_MAIT
CCTTTCTCAGCGATCC	T8_Naive
CCTTTCTCATCGGACC	T8_Mem
CCTTTCTGTAAGGATT	T8_Mem
CCTTTCTGTGCACGAA	T8_Mem
CGAACATAGAGTACAT	T8_Mem
CGAACATAGATTACCC	T8_Mem_Prolif
CGAATGTAGCGATTCT	T8_Mem
CGAATGTAGGAATCGC	T8_Mem
CGAATGTCAATTGCTG	T8_Naive
CGAATGTCAGCCACCA	T8_Naive
CGACCTTAGAAAGTGG	T8_Naive
CGACCTTAGTCCCACG	T8_Naive
CGACCTTGTCGACTGC	T8_Mem
CGACCTTGTTCTCATT	T8_Mem
CGACTTCAGAATAGGG	T8_Mem
CGACTTCAGCAATATG	T8_Naive
CGACTTCGTGGGTCAA	T8_Mem_Prolif
CGACTTCTCAGGCAAG	T8_Mem
CGAGCCACACAGACAG	T8_Mem
CGAGCCACACCTTGTC	T8_Mem_Prolif
CGAGCCATCCGAATGT	T8_Mem
CGAGCCATCGCCTGAG	T8_MAIT
CGATCGGAGCGTTTAC	T8_Mem
CGATCGGGTAGCGCTC	T8_Mem
CGATGGCAGCCACGCT	T8_Mem
CGATGGCTCGGAAATA	T8_Mem
CGATGTAAGCCAGTTT	T8_Naive
CGATGTACACGGTAGA	T8_Naive
CGATGTACAGCCTGTG	T8_Mem
CGATGTACATCACCCT	T8_Mem
CGATGTACATCGATGT	T8_Naive
CGATGTACATTGGCGC	T8_Mem
CGATGTATCCACTGGG	T8_Mem
CGATTGAGTACCGTTA	T8_Mem
CGATTGAGTACTCTCC	T8_Mem
CGATTGAGTGTAAGTA	T8_Mem
CGATTGATCCGCGTTT	T8_Mem_Prolif
CGCGGTAAGTGCCAGA	T8_Mem
CGCGGTACATGCCCGA	T8_MAIT
CGCGTTTAGATGTGGC	T8_Mem_Prolif
CGCGTTTCATCCGGGT	T8_Mem
CGCGTTTTCTCCCTGA	T8_Mem
CGCTATCCATGGTCAT	T8_MAIT
CGCTATCTCCCGGATG	T8_Mem
CGCTGGAGTAAATGAC	T8_Naive
CGCTGGAGTACGAAAT	T8_Mem
CGCTGGAGTGCAGACA	T8_MAIT
CGCTGGAGTGCCTGGT	T8_Mem
CGCTGGAGTTCACGGC	T8_Mem
CGCTGGATCACCCTCA	T8_Mem
CGCTGGATCTAACTGG	T8_Mem
CGCTTCAAGTGTACCT	T8_Naive
CGCTTCACAGTTCCCT	T8_Mem
CGCTTCATCACAATGC	T8_Naive
CGGACACCAGACAAGC	T8_Naive
CGGACACGTAGCGTCC	T8_Mem
CGGACACGTCACAAGG	T8_Mem
CGGACACTCAGGTTCA	T8_Mem
CGGACACTCGAATCCA	T8_Mem
CGGACACTCTAGAGTC	T8_Mem
CGGACGTAGCCCAGCT	T8_Mem
CGGACGTAGGAGTCTG	T8_Mem
CGGACGTCACAGGTTT	T8_Mem
CGGACGTGTCTGCGGT	T8_Mem
CGGACTGAGTAGTGCG	T8_Naive
CGGACTGTCGCGGATC	T8_Naive
CGGAGCTAGAGGGCTT	T8_Mem
CGGAGCTAGTCTCCTC	T8_Mem
CGGAGCTCAGCTGTAT	T8_Mem
CGGAGCTGTAGCACGA	T8_Mem
CGGAGTCAGTTCGCAT	T8_Mem
CGGCTAGAGACTAGAT	T8_Mem
CGGCTAGCAAGGTTTC	T8_Mem_Prolif
CGGCTAGCACAACTGT	T8_MAIT
CGGCTAGGTAATAGCA	T8_Naive
CGGCTAGGTCAAGCGA	T8_MAIT
CGGGTCAAGAATAGGG	T8_Mem
CGGGTCAAGACATAAC	T8_Mem
CGGGTCAAGAGTGACC	T8_Mem
CGGGTCAAGTGGTCCC	T8_Mem
CGGGTCAGTTAAAGAC	T8_Naive
CGGTTAAAGACTAGAT	T8_Mem
CGGTTAAAGGTGCTAG	T8_Mem
CGGTTAACATCACCCT	T8_Naive
CGGTTAAGTCAATACC	T8_Mem
CGGTTAAGTTTGTGTG	T8_Mem
CGGTTAATCACTCTTA	T8_Mem
CGGTTAATCGGAGCAA	T8_Mem
CGGTTAATCTGTTGAG	T8_Mem
CGTAGCGGTTCCAACA	T8_Mem
CGTAGGCAGACATAAC	T8_Mem
CGTAGGCTCTTGCCGT	T8_Mem
CGTCACTAGAACAATC	T8_Mem
CGTCACTCATATACCG	T8_Naive
CGTCACTGTTAGATGA	T8_Mem
CGTCACTTCACTTACT	T8_Mem_Prolif
CGTCAGGAGACAGGCT	T8_Mem
CGTCAGGGTGTTCTTT	T8_MAIT
CGTCAGGTCCGCTGTT	T8_Mem
CGTCCATAGCGCCTTG	T8_Mem
CGTCCATTCAGCCTAA	T8_Mem
CGTCCATTCAGGCCCA	T8_Mem
CGTCTACAGAGTACAT	T8_Naive
CGTCTACCAGGCTGAA	T8_Mem
CGTGAGCAGCTAACTC	T8_Naive
CGTGTCTAGACGCTTT	T8_Naive
CGTGTCTAGTCGTTTG	T8_Mem
CGTGTCTCAAGCCGTC	T8_Mem
CGTGTCTGTCACCTAA	T8_Mem
CGTGTCTGTGGCTCCA	T8_Naive
CGTGTCTGTGTGTGCC	T8_Mem
CGTTAGACAAGTACCT	T8_Mem
CGTTAGAGTTCAGTAC	T8_Mem
CGTTCTGAGGGATGGG	T8_Mem
CGTTCTGCACCAGCAC	T8_Mem
CTAACTTAGTTAAGTG	T8_Naive
CTAACTTCATGAACCT	T8_Mem
CTAACTTGTTAGAACA	T8_Naive
CTAACTTTCTTCGGTC	T8_Naive
CTAAGACAGCGTGAGT	T8_Naive
CTAAGACCAAAGAATC	T8_Mem
CTAAGACTCATGTGGT	T8_Mem
CTAATGGAGAAGGTGA	T8_Mem
CTAATGGCAAGGCTCC	T8_MAIT
CTACACCGTTGAACTC	T8_Naive
CTACATTAGAGAACAG	T8_Mem
CTACATTCACTGTGTA	T8_Mem
CTACATTCATATACGC	T8_Naive
CTACATTGTTCTGAAC	T8_Naive
CTACATTTCTGTACGA	T8_Mem
CTACCCAGTGATGTCT	T8_Mem
CTACGTCAGTACATGA	T8_Mem
CTACGTCAGTTGCAGG	T8_Mem
CTACGTCCAGGGATTG	T8_Naive
CTACGTCCAGGTGCCT	T8_Mem
CTACGTCCATGTCGAT	T8_Naive
CTACGTCGTCATGCCG	T8_Mem
CTAGAGTCAAGAAGAG	T8_Mem
CTAGAGTCAGAGTGTG	T8_Mem
CTAGAGTCAGCAGTTT	T8_Mem
CTAGAGTCATCACGTA	T8_Mem
CTAGAGTGTACGACCC	T8_Mem
CTAGAGTGTTAGTGGG	T8_Mem
CTAGCCTCAGGTGCCT	T8_Mem
CTCACACCAAATACAG	T8_MAIT
CTCACACCACAGACAG	T8_Mem_Prolif
CTCACACTCCGCAGTG	T8_Mem
CTCACACTCTATCGCC	T8_Naive
CTCAGAAAGCCCAGCT	T8_Mem
CTCAGAACACATCTTT	T8_Mem
CTCAGAAGTCATGCCG	T8_Mem
CTCAGAAGTTTGGGCC	T8_Mem
CTCAGAATCCGTCATC	T8_Mem
CTCATTACATAGTAAG	T8_Naive
CTCATTAGTACAGTTC	T8_Naive
CTCATTAGTCAGTGGA	T8_Naive
CTCATTATCGGCGGTT	T8_Mem_Prolif
CTCCTAGCACCCAGTG	T8_Naive
CTCCTAGCATGGTCAT	T8_Mem
CTCCTAGGTCTAGTCA	T8_Mem
CTCCTAGGTTTAAGCC	T8_Mem
CTCGAAAAGTGCGTGA	T8_Mem
CTCGAAAGTGAGTATA	T8_Mem
CTCGAAATCACTTACT	T8_Mem
CTCGAGGCACAGACTT	T8_Mem
CTCGAGGCATGGTCAT	T8_Mem
CTCGGAGCACACATGT	T8_Mem
CTCGGAGGTATAGGGC	T8_Mem
CTCGGAGTCTACCAGA	T8_Mem
CTCGGAGTCTATCCTA	T8_Mem
CTCGGGAAGATCCCAT	T8_Mem
CTCGGGAGTCAACTGT	T8_Mem
CTCGGGAGTGATGATA	T8_Naive
CTCGTACAGACTTTCG	T8_Naive
CTCGTACCAACGATGG	T8_Mem
CTCGTACGTTACGACT	T8_Mem
CTCGTACTCCTGTAGA	T8_Mem
CTCGTCAAGAAGGGTA	T8_Mem
CTCGTCAAGGTACTCT	T8_Mem
CTCGTCAGTACTCAAC	T8_Mem
CTCGTCATCCGCATCT	T8_Mem
CTCGTCATCTGCGTAA	T8_Naive
CTCTAATCAGCAGTTT	T8_Mem
CTCTACGAGGTGGGTT	T8_Mem
CTCTACGCACATTTCT	T8_Mem
CTCTACGCAGACGCCT	T8_Mem
CTCTACGTCCTTGCCA	T8_Mem
CTCTGGTAGCGATGAC	T8_Mem
CTCTGGTAGTGCCATT	T8_Naive
CTCTGGTCACAAGACG	T8_Mem
CTCTGGTTCGCATGGC	T8_Mem
CTGAAACAGTAAGTAC	T8_Mem
CTGAAACAGTTGTCGT	T8_Mem
CTGAAACGTCCAGTGC	T8_Mem
CTGAAACTCTACTTAC	T8_Mem
CTGAAGTCACCATCCT	T8_Mem
CTGAAGTGTACAGACG	T8_Mem
CTGAAGTGTAGTGAAT	T8_Naive
CTGAAGTGTATGAATG	T8_Mem
CTGAAGTTCTCGTATT	T8_Mem
CTGATAGGTTATTCTC	T8_Mem
CTGATCCAGTACGACG	T8_Naive
CTGATCCGTCTGCAAT	T8_Mem
CTGATCCTCACATACG	T8_Mem
CTGATCCTCATCTGTT	T8_Mem
CTGCCTAAGTAGCGGT	T8_MAIT
CTGCCTAGTGTTTGGT	T8_Mem
CTGCTGTAGTCCTCCT	T8_Naive
CTGGTCTGTAAATGAC	T8_Mem
CTGGTCTGTTATTCTC	T8_Mem
CTGTGCTAGACTAGAT	T8_Mem
CTGTGCTAGTACATGA	T8_Mem
CTGTGCTTCGAGAGCA	T8_Mem
CTGTTTAAGCTAAACA	T8_MAIT
CTGTTTAAGTGCGTGA	T8_Naive
CTGTTTAGTATAAACG	T8_Mem
CTGTTTAGTTGTGGAG	T8_Mem
CTGTTTATCAGTTAGC	T8_Naive
CTGTTTATCATGCAAC	T8_Mem
CTGTTTATCCAGATCA	T8_Mem
CTTAACTAGCTTATCG	T8_Naive
CTTAACTAGTTCGCAT	T8_Mem
CTTAACTGTTGCGCAC	T8_Mem
CTTACCGAGATAGCAT	T8_MAIT
CTTACCGCAGCCTTGG	T8_MAIT
CTTACCGGTCAGAATA	T8_Naive
CTTACCGTCATCTGTT	T8_Mem
CTTAGGATCAGGATCT	T8_Mem
CTTCTCTAGAACAACT	T8_Mem_Prolif
CTTCTCTAGATGCCTT	T8_Mem
CTTCTCTAGTCCAGGA	T8_Mem
CTTCTCTGTCATCGGC	T8_Mem
CTTCTCTGTTGTACAC	T8_Naive
CTTGGCTGTAGCGTAG	T8_Mem
CTTTGCGCAATCTGCA	T8_Mem
CTTTGCGTCATATCGG	T8_Naive
CTTTGCGTCCAATGGT	T8_Mem
GAAACTCAGCCCAGCT	T8_Mem_Prolif
GAAACTCAGGTGACCA	T8_Mem
GAAACTCCATTCACTT	T8_Naive
GAAACTCGTAGGCATG	T8_Naive
GAAACTCGTAGTGAAT	T8_MAIT
GAAACTCGTCCATCCT	T8_Mem
GAAACTCGTGCATCTA	T8_Mem
GAAACTCTCAATCTCT	T8_Mem
GAAACTCTCAGGTAAA	T8_Mem
GAAACTCTCGGTTAAC	T8_Mem
GAAATGAAGACAGAGA	T8_Mem
GAAATGAAGACTAAGT	T8_Mem
GAAATGAGTTCATGGT	T8_Naive
GAAATGATCACTGGGC	T8_Mem
GAAATGATCGGTTAAC	T8_Mem
GAACATCAGGTGGGTT	T8_Mem
GAACATCCATCGTCGG	T8_Mem
GAACATCGTGCCTTGG	T8_Mem_Prolif
GAACATCTCGTGGACC	T8_Mem
GAACCTACAAGACACG	T8_Mem
GAACGGAAGAACAACT	T8_Mem
GAACGGAAGTCCAGGA	T8_Mem
GAACGGACACAGACAG	T8_Mem
GAACGGACAGCTGTTA	T8_Naive
GAAGCAGCACCTATCC	T8_Mem
GAAGCAGGTGTAACGG	T8_Mem
GAATAAGCAGCGTCCA	T8_Naive
GAATAAGTCGATCCCT	T8_Naive
GAATAAGTCTCAAACG	T8_Mem_Prolif
GAATGAAAGAAGATTC	T8_Mem
GAATGAACACAACGCC	T8_Naive
GAATGAAGTCATGCCG	T8_Naive
GAATGAAGTTGTACAC	T8_Mem
GACACGCTCGGCCGAT	T8_Mem
GACACGCTCGTTTAGG	T8_Mem
GACAGAGAGCTTCGCG	T8_Naive
GACAGAGAGTACATGA	T8_Naive
GACAGAGTCTCCCTGA	T8_Mem
GACAGAGTCTGCGGCA	T8_Mem_Prolif
GACCAATAGATGTTAG	T8_Naive
GACCAATGTCTAGAGG	T8_Mem
GACCAATTCCAAACAC	T8_Mem
GACCAATTCGTGGACC	T8_Mem
GACCTGGAGATGTGGC	T8_Mem
GACGCGTAGAAAGTGG	T8_Mem
GACGCGTAGTTGCAGG	T8_Mem
GACGGCTTCGTTTAGG	T8_Mem
GACGTGCAGACAAGCC	T8_Mem
GACGTGCAGATGTTAG	T8_Naive
GACGTGCAGTGGAGTC	T8_Mem
GACGTGCCACCTCGTT	T8_Mem
GACGTGCGTCCAACTA	T8_Naive
GACGTGCGTTCAGTAC	T8_Mem
GACGTGCTCTCCAACC	T8_Mem
GACGTTAGTAAGGATT	T8_Mem
GACTAACTCGAACTGT	T8_Mem
GACTAACTCGAGAACG	T8_Mem
GACTACAAGACCACGA	T8_Naive
GACTACATCAACACAC	T8_Mem
GACTGCGAGCGATTCT	T8_Naive
GACTGCGCATGACATC	T8_Naive
GACTGCGTCAGTGTTG	T8_Naive
GACTGCGTCTTCAACT	T8_Mem
GAGCAGAAGCCGATTT	T8_Mem
GAGCAGAAGCGTTTAC	T8_Mem
GAGGTGAAGATGGCGT	T8_Mem
GAGGTGATCGAGAGCA	T8_Mem
GAGTCCGAGGATGGTC	T8_Mem
GAGTCCGCAGACAAGC	T8_MAIT
GAGTCCGTCATAACCG	T8_Mem
GAGTCCGTCGTACGGC	T8_Mem
GAGTCCGTCTCGAGTA	T8_Mem
GATCAGTAGTCGAGTG	T8_Mem
GATCAGTGTCAAAGAT	T8_Naive
GATCAGTGTTGCGCAC	T8_Mem
GATCAGTTCCCTTGTG	T8_Mem
GATCGATAGCAGATCG	T8_Mem
GATCGATCATCCGTGG	T8_Mem
GATCGATGTGCTCTTC	T8_Naive
GATCGATTCATAGCAC	T8_Mem
GATCGATTCTGTACGA	T8_Mem
GATCGCGCAGGAACGT	T8_Mem
GATCGCGGTGATAAGT	T8_Mem_Prolif
GATCGTATCCCTAATT	T8_Mem
GATCGTATCCGTTGTC	T8_Mem
GATCGTATCGCGTTTC	T8_Naive
GATCTAGCACATGTGT	T8_Naive
GATGAAAAGGGAAACA	T8_Naive
GATGAAACAATCCAAC	T8_Naive
GATGAAAGTTGGTTTG	T8_Mem
GATGAGGGTACCAGTT	T8_Mem
GATGCTAAGACCCACC	T8_Mem
GATGCTAAGAGTACAT	T8_Naive
GATGCTAGTGATAAGT	T8_Mem
GATTCAGCAAGACGTG	T8_Mem
GATTCAGCAAGCCATT	T8_Mem
GATTCAGGTCAAGCGA	T8_Mem
GCAAACTAGAGTAATC	T8_Naive
GCAAACTAGCGATAGC	T8_Mem
GCAAACTAGTCTTGCA	T8_Naive
GCAAACTCACAGGTTT	T8_Mem
GCAAACTCATCGGGTC	T8_Naive
GCAAACTGTACAGTGG	T8_Naive
GCAAACTGTTGGTGGA	T8_Mem
GCAAACTTCCATGAAC	T8_Mem
GCAATCACACCAGGTC	T8_Naive
GCAATCACAGCTATTG	T8_Naive
GCAATCAGTACATCCA	T8_Mem
GCACATAGTGTAATGA	T8_Naive
GCACTCTCAATCGGTT	T8_Naive
GCACTCTTCACCGTAA	T8_Mem
GCACTCTTCCTTTACA	T8_Mem
GCAGCCACATCACGTA	T8_Mem
GCAGCCAGTCATCGGC	T8_Mem
GCAGCCAGTTATCCGA	T8_Mem
GCAGCCATCTTAACCT	T8_Mem
GCAGTTAAGGATGTAT	T8_Mem
GCAGTTAAGTACATGA	T8_Mem
GCAGTTAGTCATATCG	T8_Mem
GCATACAGTCGAGATG	T8_Naive
GCATGATAGTTGTAGA	T8_Naive
GCATGATTCAACGAAA	T8_Mem
GCATGCGAGCTTCGCG	T8_Mem
GCATGCGTCAGGTAAA	T8_Naive
GCATGCGTCCAGAAGG	T8_Naive
GCATGTACACTAAGTC	T8_Mem
GCATGTAGTCGTTGTA	T8_Naive
GCCAAATGTAACGACG	T8_Naive
GCCTCTACACCACGTG	T8_MAIT
GCCTCTAGTAACGTTC	T8_Mem
GCCTCTAGTCCGTCAG	T8_Mem
GCCTCTAGTCGACTGC	T8_Mem
GCCTCTATCGTAGGTT	T8_Mem
GCGACCAAGCGATAGC	T8_Mem
GCGACCACAGATTGCT	T8_Mem
GCGACCAGTAAGTGGC	T8_Mem
GCGACCATCATCGATG	T8_MAIT
GCGACCATCCTTGACC	T8_Naive
GCGACCATCTCTTATG	T8_Mem
GCGACCATCTGCGGCA	T8_Mem
GCGACCATCTTTAGTC	T8_Mem
GCGAGAACAGGCAGTA	T8_Naive
GCGAGAAGTACAGACG	T8_Mem
GCGCAACAGCTATGCT	T8_Mem
GCGCAACGTAAACCTC	T8_Mem
GCGCAACTCACGGTTA	T8_MAIT
GCGCAGTGTCTCAACA	T8_Mem
GCGCAGTGTGAGGGAG	T8_Mem
GCGCAGTGTGGTACAG	T8_Mem
GCGCCAAAGACTCGGA	T8_Mem
GCGCCAAAGATAGGAG	T8_Naive
GCGCCAAAGTGTTGAA	T8_Naive
GCGCCAACAAGCCTAT	T8_Mem
GCGCCAACACTCTGTC	T8_Mem
GCGCGATGTTCACCTC	T8_Naive
GCGCGATGTTGGGACA	T8_Mem
GCGGGTTAGACAGACC	T8_Mem
GCGGGTTGTCGCGAAA	T8_Mem
GCGGGTTGTTAGTGGG	T8_MAIT
GCGGGTTTCTACTTAC	T8_Mem
GCTCCTAAGCCCAGCT	T8_Naive
GCTCCTAAGGACACCA	T8_Naive
GCTCCTAGTGTGAAAT	T8_Mem
GCTCCTAGTTATGTGC	T8_Mem
GCTCCTAGTTCCGGCA	T8_Naive
GCTCCTAGTTCGCGAC	T8_Mem
GCTCCTATCTGGTTCC	T8_Mem
GCTCTGTCATATGCTG	T8_Naive
GCTCTGTTCCTTCAAT	T8_Mem
GCTGCGACACCGAATT	T8_Mem
GCTGCTTAGAGTCTGG	T8_Mem
GCTGCTTCACTCAGGC	T8_Naive
GCTGCTTGTCCATCCT	T8_MAIT
GCTGCTTTCCGCGCAA	T8_Naive
GCTGGGTAGTGTGAAT	T8_Mem
GCTGGGTGTATCACCA	T8_Mem
GCTGGGTGTCCGAATT	T8_Mem
GCTGGGTGTGATAAGT	T8_Naive
GCTTCCAAGACTGGGT	T8_Mem
GCTTCCAAGGATGCGT	T8_Mem
GCTTCCACACAACGTT	T8_Mem
GCTTGAACAGACAGGT	T8_Mem
GCTTGAAGTATTACCG	T8_Naive
GCTTGAAGTATTAGCC	T8_Mem
GCTTGAATCCACGTTC	T8_Mem
GGAAAGCAGAAGGGTA	T8_Naive
GGAAAGCCAAGCCGCT	T8_Naive
GGAAAGCTCACTGGGC	T8_Mem
GGAAAGCTCCGGCACA	T8_Naive
GGAACTTGTATGAATG	T8_Mem
GGACAAGTCGCATGGC	T8_Naive
GGACAAGTCTTACCTA	T8_Mem
GGACAGAAGAAGGACA	T8_Mem
GGACAGAGTCATTAGC	T8_Mem
GGACATTAGGAGTACC	T8_Mem
GGACATTAGGTGTTAA	T8_Mem
GGACATTCAAGCTGGA	T8_Mem
GGACATTGTGTGCGTC	T8_Mem
GGACATTTCAGATAAG	T8_Mem_Prolif
GGACGTCAGAACAACT	T8_Naive
GGACGTCCACCCTATC	T8_Mem
GGACGTCCATTACGAC	T8_Naive
GGAGCAACATCGATTG	T8_Mem
GGATGTTCAGGAATGC	T8_Naive
GGATTACAGAAACCTA	T8_Mem
GGATTACCACACAGAG	T8_Mem
GGCAATTAGCCGGTAA	T8_Naive
GGCAATTAGGGTCTCC	T8_Naive
GGCAATTTCTTTAGGG	T8_Mem
GGCCGATGTAGCGCAA	T8_Naive
GGCTCGAAGACTAGAT	T8_Naive
GGCTCGAAGTAATCCC	T8_Mem
GGCTCGAGTAAGTGTA	T8_MAIT
GGCTCGATCTCGAGTA	T8_Mem
GGCTGGTAGCAATATG	T8_Mem
GGCTGGTAGCCACGCT	T8_Naive
GGCTGGTAGGCAAAGA	T8_Naive
GGCTGGTGTGTTAAGA	T8_Mem
GGCTGGTTCAGCATGT	T8_Naive
GGGACCTGTACGAAAT	T8_Mem
GGGACCTGTTTGACTG	T8_Naive
GGGACCTTCAACGGCC	T8_MAIT
GGGAGATAGACTGTAA	T8_Naive
GGGAGATGTTGGAGGT	T8_MAIT
GGGATGAGTGTTTGTG	T8_Mem
GGGCACTCAAATCCGT	T8_Mem
GGGCATCAGGATCGCA	T8_Mem_Prolif
GGGCATCTCTAACTGG	T8_Mem
GGGCATCTCTTGAGGT	T8_Naive
GGGTCTGCAAGTACCT	T8_Mem
GGGTCTGGTCAATGTC	T8_MAIT
GGGTTGCTCTGTCAAG	T8_Mem_Prolif
GGTATTGAGGCTAGAC	T8_Mem
GGTATTGGTCCGAAGA	T8_Naive
GGTGCGTCATGGTCAT	T8_Naive
GGTGCGTGTACTTAGC	T8_Mem
GGTGCGTGTCAGCTAT	T8_Mem
GGTGCGTGTGCTGTAT	T8_Mem
GGTGCGTGTTACGCGC	T8_Naive
GGTGCGTTCATCTGTT	T8_Mem
GGTGCGTTCCTCTAGC	T8_Mem
GGTGCGTTCTCCCTGA	T8_Mem
GGTGTTAGTGGGTATG	T8_Mem
GGTGTTATCGCGGATC	T8_Mem
GTAACGTAGGCTCATT	T8_Mem
GTAACGTCATGAGCGA	T8_Mem
GTAACGTGTAACGTTC	T8_Mem
GTAACGTGTCTCTCGT	T8_Mem
GTAACTGGTCAGAAGC	T8_Mem
GTAACTGTCAGTTCGA	T8_Naive
GTAACTGTCCTTTCGG	T8_Naive
GTACGTAAGAAAGTGG	T8_Mem_Prolif
GTACGTAAGTCTTGCA	T8_Mem
GTACGTAGTACCGAGA	T8_MAIT
GTACGTAGTTCAGACT	T8_Mem
GTACGTATCCAGAAGG	T8_MAIT
GTACTCCAGACCTAGG	T8_Mem_Prolif
GTACTCCAGCCAACAG	T8_Mem
GTACTCCGTTATCGGT	T8_MAIT
GTACTCCTCACTCCTG	T8_Mem
GTACTTTAGAGAGCTC	T8_Mem
GTACTTTCAATCACAC	T8_Mem
GTAGGCCTCCGTCATC	T8_Mem
GTAGTCATCACGATGT	T8_Mem
GTATCTTCACGAGAGT	T8_Naive
GTATCTTGTCCGTGAC	T8_Mem
GTATCTTGTTTGTTGG	T8_Mem
GTATCTTTCTCCGGTT	T8_Mem
GTATCTTTCTCTTGAT	T8_Naive
GTATTCTCAGATGAGC	T8_Mem
GTATTCTCATTGTGCA	T8_Mem
GTATTCTGTGCAGACA	T8_Mem
GTATTCTTCGTATCAG	T8_Mem
GTCAAGTCATGCCTAA	T8_Mem
GTCAAGTGTACTCGCG	T8_Mem_Prolif
GTCACAACAAGTAGTA	T8_Mem
GTCACAAGTAGAAGGA	T8_Mem
GTCACAAGTAGCAAAT	T8_Mem
GTCACGGAGGAGTACC	T8_Naive
GTCACGGCATCGACGC	T8_Naive
GTCACGGGTAACGACG	T8_MAIT
GTCACGGGTAGCTAAA	T8_Mem
GTCATTTAGACAGAGA	T8_Mem_Prolif
GTCATTTAGCAGCGTA	T8_Mem
GTCATTTCAAACGCGA	T8_Mem_Prolif
GTCATTTCACCGATAT	T8_Naive
GTCATTTGTAGCGCAA	T8_Mem
GTCATTTGTTCTGGTA	T8_Naive
GTCATTTTCAACCAAC	T8_Mem
GTCCTCAGTAAACGCG	T8_Mem
GTCCTCAGTATAGTAG	T8_Mem
GTCCTCAGTCGGATCC	T8_Mem
GTCCTCATCAGTCAGT	T8_Mem
GTCGGGTTCAGTGTTG	T8_Mem
GTCGTAACATGAACCT	T8_Mem
GTCTCGTGTTAGAACA	T8_Mem
GTCTTCGTCGCAGGCT	T8_Mem
GTGAAGGAGGAGCGTT	T8_Mem
GTGAAGGGTTGACGTT	T8_Mem
GTGAAGGTCAGCCTAA	T8_Naive
GTGAAGGTCCGCATAA	T8_Mem
GTGCAGCAGGTTCCTA	T8_Naive
GTGCAGCCATCTCCCA	T8_Mem
GTGCAGCGTGAGTGAC	T8_Mem
GTGCATAAGATGTGGC	T8_Mem
GTGCATAGTATAGGGC	T8_MAIT
GTGCATATCATAGCAC	T8_MAIT
GTGCGGTAGGTAGCCA	T8_Naive
GTGCTTCCATCTCCCA	T8_Mem
GTGCTTCGTCTAAAGA	T8_Mem
GTGGGTCGTTTGGCGC	T8_Mem
GTGGGTCTCTTTCCTC	T8_Mem
GTGTGCGAGCTGAACG	T8_Mem
GTGTGCGAGGAGTTGC	T8_Mem
GTGTGCGCATGGTAGG	T8_Mem
GTGTGCGTCACATACG	T8_Mem
GTGTTAGTCTCTTGAT	T8_Mem
GTTAAGCCAAGTCATC	T8_Naive
GTTAAGCGTACCATCA	T8_Naive
GTTAAGCTCTTTACAC	T8_Mem
GTTCATTAGGAATTAC	T8_Mem
GTTCATTGTGAGGGAG	T8_Mem
GTTCATTGTTTAGCTG	T8_Naive
GTTCGGGCATGTTGAC	T8_Mem
GTTCGGGTCAACTCTT	T8_Mem
GTTCTCGCAGATAATG	T8_Mem
GTTCTCGGTAAACCTC	T8_Naive
GTTCTCGGTTTGGCGC	T8_Mem_Prolif
GTTTCTAAGACCACGA	T8_Mem
GTTTCTACAAGGCTCC	T8_Mem
GTTTCTACACCATCCT	T8_Mem
GTTTCTAGTTCGGGCT	T8_Mem
TAAGAGATCATTTGGG	T8_Mem
TAAGCGTAGGTGACCA	T8_Naive
TAAGCGTCACTGTTAG	T8_Naive
TAAGTGCAGTGCCATT	T8_Mem
TACACGATCACGCGGT	T8_Naive
TACACGATCTGCCCTA	T8_Mem
TACACGATCTTGCAAG	T8_Naive
TACAGTGCAATTCCTT	T8_Mem_Prolif
TACAGTGTCCTCGCAT	T8_Naive
TACCTATAGACTTGAA	T8_Mem
TACCTATAGTACGCCC	T8_Mem
TACCTTACAAGGTTCT	T8_Naive
TACCTTACAGTATAAG	T8_Mem
TACCTTAGTTAAGGGC	T8_Mem_Prolif
TACCTTAGTTCGGCAC	T8_Mem
TACCTTAGTTTGTTGG	T8_Mem
TACCTTATCCAGAAGG	T8_Naive
TACCTTATCGCATGAT	T8_Naive
TACCTTATCGCGTAGC	T8_Naive
TACCTTATCGTATCAG	T8_Mem
TACCTTATCTGGTTCC	T8_Naive
TACGGATAGTTTGCGT	T8_Mem
TACGGATGTACTTAGC	T8_Mem
TACGGATGTGACAAAT	T8_Mem
TACGGGCAGCCAGAAC	T8_Mem
TACGGGCGTTTGCATG	T8_MAIT
TACGGGCTCGGAGGTA	T8_Mem
TACGGGCTCTACCTGC	T8_Mem
TACGGTAGTAGGCATG	T8_Mem
TACTCATAGACAAGCC	T8_Mem
TACTCATAGCTATGCT	T8_Mem
TACTCATAGTGTACCT	T8_Naive
TACTCATGTAGCGCAA	T8_Mem
TACTCGCAGAGCTGCA	T8_Mem
TACTCGCGTCCTAGCG	T8_Mem_Prolif
TACTCGCGTTTCGCTC	T8_Mem
TACTCGCTCACCAGGC	T8_Mem
TACTTACAGCTCCCAG	T8_Mem_Prolif
TACTTACTCTCAAACG	T8_Mem
TACTTGTCACAACTGT	T8_Mem
TACTTGTGTAAATGAC	T8_Naive
TACTTGTTCCGTTGCT	T8_Mem
TACTTGTTCGTCCGTT	T8_Naive
TAGACCAAGAAGGACA	T8_Naive
TAGACCACAGCCAGAA	T8_Mem
TAGACCAGTTCAGGCC	T8_Naive
TAGAGCTAGCTGGAAC	T8_Mem
TAGAGCTTCATGCATG	T8_Mem
TAGGCATAGTATTGGA	T8_Naive
TAGGCATGTTAAGACA	T8_Naive
TAGGCATGTTTGTGTG	T8_Naive
TAGTGGTAGCTAACAA	T8_Mem
TAGTGGTAGGAATTAC	T8_Mem
TAGTGGTTCAGAGGTG	T8_Mem
TAGTTGGAGGATTCGG	T8_Naive
TAGTTGGCAGACAAAT	T8_Mem
TAGTTGGGTTAGATGA	T8_Mem
TAGTTGGTCAACTCTT	T8_Mem
TATCAGGCAAGCCGCT	T8_Mem
TATCAGGCACTTCTGC	T8_Mem
TATCAGGCATGGTAGG	T8_Mem
TATCAGGGTACCTACA	T8_Mem
TATCTCAGTATAAACG	T8_Naive
TATCTCATCCCTTGTG	T8_Mem_Prolif
TATGCCCGTATAGGGC	T8_Mem
TATTACCCATCTCGCT	T8_Naive
TATTACCGTGTGCGTC	T8_Mem_Prolif
TCAACGACATCCTAGA	T8_Mem
TCAACGAGTTGTGGCC	T8_MAIT
TCAATCTAGATCCGAG	T8_Naive
TCAATCTAGGTAAACT	T8_Naive
TCAATCTCAAGCTGGA	T8_Mem
TCACAAGAGCAGACTG	T8_Mem
TCACAAGAGGTGCTAG	T8_Naive
TCACAAGTCTCTGAGA	T8_Mem
TCACGAACAAGGGTCA	T8_Mem
TCACGAAGTAAAGTCA	T8_Mem
TCACGAAGTGGTAACG	T8_Mem
TCACGAAGTTCCTCCA	T8_Mem
TCAGATGAGTCCGTAT	T8_Mem
TCAGATGCAGGTTTCA	T8_Mem
TCAGATGGTTTGTGTG	T8_Mem
TCAGCAAGTAGAGTGC	T8_Mem
TCAGCAATCTCCGGTT	T8_Mem
TCAGCTCAGACTAAGT	T8_Mem
TCAGCTCAGAGAGCTC	T8_Mem
TCAGCTCAGTCGAGTG	T8_Naive
TCAGCTCTCACCCTCA	T8_Mem
TCAGCTCTCGAATGCT	T8_Naive
TCAGCTCTCGAGGTAG	T8_MAIT
TCAGGATGTAATAGCA	T8_Mem
TCAGGTAAGAAACGCC	T8_Mem
TCATTACAGACTGGGT	T8_Mem_Prolif
TCATTACAGCATGGCA	T8_MAIT
TCATTACAGCTTCGCG	T8_Mem_Prolif
TCATTACGTCTCATCC	T8_Naive
TCATTACTCGCTGATA	T8_Mem
TCATTTGAGCAGGCTA	T8_Naive
TCATTTGAGGAGTACC	T8_Naive
TCATTTGTCTTTCCTC	T8_Mem
TCCACACCACGTCTCT	T8_Mem
TCCACACGTGACTCAT	T8_Mem
TCCCGATTCAGCTTAG	T8_Mem
TCGAGGCCATGGGACA	T8_Naive
TCGCGAGCAGTAGAGC	T8_Naive
TCGCGAGGTCTAGCGC	T8_Mem
TCGCGTTAGATCGGGT	T8_Mem
TCGCGTTTCCCTGACT	T8_Mem
TCGGGACAGACCTTTG	T8_Mem
TCGGGACAGCTACCTA	T8_Mem
TCGGGACTCAAACCAC	T8_Mem
TCGGTAAAGTCTTGCA	T8_Mem
TCGGTAACAGACAGGT	T8_Naive
TCGGTAATCAGCATGT	T8_Naive
TCGTAGAAGCTGGAAC	T8_Mem
TCGTAGAGTCATCCCT	T8_Mem
TCGTAGATCACAGTAC	T8_Mem
TCTATTGAGAAGGGTA	T8_Naive
TCTATTGAGGCTCATT	T8_Mem
TCTCATAAGACAAGCC	T8_Mem
TCTCATATCACTCTTA	T8_Naive
TCTCATATCCACGCAG	T8_Mem
TCTCTAAAGTGTACGG	T8_Mem
TCTCTAACAATGAATG	T8_Mem
TCTCTAATCGCGTAGC	T8_Mem
TCTGAGAAGGACACCA	T8_Mem_Prolif
TCTGAGATCACCCGAG	T8_Mem
TCTGGAAAGCTGTTCA	T8_Mem
TCTGGAACACACCGCA	T8_Mem
TCTGGAAGTCCGACGT	T8_Mem
TCTTCGGAGAGGTTAT	T8_Mem
TCTTCGGAGCGCTTAT	T8_Naive
TCTTCGGTCGAATCCA	T8_Naive
TCTTCGGTCTGTCTAT	T8_Mem
TCTTTCCTCCATGCTC	T8_Mem
TGAAAGACAAACAACA	T8_Mem
TGAAAGACATTGGCGC	T8_Mem
TGAAAGAGTCATCGGC	T8_Mem
TGAAAGAGTGAGCGAT	T8_Mem
TGAAAGATCATGCATG	T8_Mem
TGAAAGATCGTTGACA	T8_MAIT
TGACAACAGCTACCTA	T8_Mem
TGACAACGTCCATCCT	T8_MAIT
TGACAACGTCCGAACC	T8_Naive
TGACAACTCCAAGTAC	T8_Mem
TGACTAGAGAGATGAG	T8_Mem_Prolif
TGACTAGAGCTATGCT	T8_Mem
TGACTAGAGTCAAGCG	T8_Mem
TGACTTTAGACTAGAT	T8_Mem
TGACTTTCATTCCTGC	T8_Mem
TGACTTTTCTACCTGC	T8_Mem
TGAGAGGAGCCTATGT	T8_Naive
TGAGAGGCACATTCGA	T8_Naive
TGAGCATAGAAGCCCA	T8_Mem
TGAGCCGCATTCACTT	T8_Naive
TGAGCCGGTGCAGGTA	T8_Naive
TGAGGGATCTATCCTA	T8_Mem
TGATTTCAGTACGCGA	T8_MAIT
TGATTTCGTATAATGG	T8_Mem
TGCACCTAGCATCATC	T8_Naive
TGCACCTAGGGCTTGA	T8_Mem
TGCACCTAGGGTCTCC	T8_Mem
TGCACCTGTGCCTGTG	T8_Naive
TGCACCTTCTTGTACT	T8_Mem
TGCCAAAAGCGTAATA	T8_Mem
TGCCCATCAGCCTTTC	T8_Mem
TGCCCATGTCACTTCC	T8_Mem
TGCCCATGTTCCATGA	T8_Naive
TGCCCATTCCTCTAGC	T8_Mem
TGCCCATTCTTGAGGT	T8_Naive
TGCCCTAAGACACGAC	T8_Mem
TGCCCTACACCCTATC	T8_Mem
TGCCCTACAGTCAGAG	T8_Mem
TGCCCTAGTCGGCATC	T8_Mem
TGCCCTAGTGTTGAGG	T8_Mem
TGCCCTATCACCACCT	T8_Mem
TGCGCAGGTACTTAGC	T8_Naive
TGCGCAGGTATATGAG	T8_Mem
TGCGGGTAGTGTCTCA	T8_Mem
TGCGGGTGTCAGTGGA	T8_Mem
TGCGTGGAGATGGCGT	T8_Mem
TGCGTGGGTACAAGTA	T8_Mem
TGCTACCCACCACCAG	T8_Naive
TGCTACCGTCCCTACT	T8_Mem
TGCTGCTAGGGTTCCC	T8_Mem
TGCTGCTAGGTGCACA	T8_Mem
TGCTGCTCAACAACCT	T8_Mem
TGCTGCTCAATAACGA	T8_Mem
TGCTGCTCACAACGCC	T8_Naive
TGCTGCTCAGAAGCAC	T8_Naive
TGCTGCTTCCAGAAGG	T8_Mem
TGCTGCTTCGTTTGCC	T8_Mem
TGCTGCTTCTGCGACG	T8_MAIT
TGGACGCAGATGTTAG	T8_Mem
TGGACGCAGCAAATCA	T8_Mem
TGGACGCCAAATACAG	T8_Naive
TGGACGCCAGTCGTGC	T8_Mem
TGGACGCTCTGCTGCT	T8_Naive
TGGCCAGAGTGACATA	T8_Mem
TGGCCAGCAAGTACCT	T8_Mem
TGGCCAGGTACTTCTT	T8_Mem
TGGCCAGGTCTCGTTC	T8_Mem
TGGCCAGTCTGCAGTA	T8_Mem
TGGCGCAAGAATTGTG	T8_Mem
TGGCGCAAGTCGCCGT	T8_Mem
TGGCGCACACCCTATC	T8_Mem_Prolif
TGGCGCACATTACGAC	T8_Naive
TGGCGCAGTCTGCAAT	T8_Mem
TGGCGCATCCATTCTA	T8_Naive
TGGTTAGAGTATCTCG	T8_Mem
TGGTTAGGTGCCTGCA	T8_Naive
TGGTTAGTCCACGACG	T8_Mem
TGGTTCCGTATATGAG	T8_Mem
TGTATTCCACCAGCAC	T8_Mem
TGTATTCCAGACAAAT	T8_Mem
TGTCCCAAGAGTAATC	T8_MAIT
TGTGGTAAGGCACATG	T8_Naive
TGTGTTTAGGGTTCCC	T8_Mem
TGTGTTTCAATACGCT	T8_Mem
TGTGTTTGTCACCTAA	T8_Mem_Prolif
TGTGTTTGTGACGGTA	T8_Naive
TGTTCCGCATTCTTAC	T8_Mem
TGTTCCGTCACCTCGT	T8_Naive
TGTTCCGTCGCCGTGA	T8_Naive
TTAACTCAGCTGCCCA	T8_Naive
TTAACTCAGTACGTTC	T8_Mem
TTAACTCCATTGTGCA	T8_Mem
TTAACTCGTCGGCACT	T8_Mem
TTAACTCGTTCAGGCC	T8_Mem
TTAGGACAGACAATAC	T8_Mem
TTAGGACAGTCAAGGC	T8_Mem_Prolif
TTAGGACCAGCTCCGA	T8_Mem
TTAGGACCATGGTTGT	T8_Naive
TTAGGCAAGAGGTACC	T8_Mem
TTAGGCAGTCGCGGTT	T8_Mem
TTAGTTCCAGTTAACC	T8_Mem
TTAGTTCGTAAACACA	T8_Naive
TTAGTTCGTAGGACAC	T8_Mem
TTCCCAGGTGACGGTA	T8_Mem
TTCGAAGCAGGTGCCT	T8_Mem_Prolif
TTCGAAGGTATTCGTG	T8_Naive
TTCGAAGGTCGGCATC	T8_Mem
TTCGAAGTCACCGGGT	T8_Mem
TTCGAAGTCCTATTCA	T8_Mem
TTCGAAGTCTCTGAGA	T8_Mem
TTCGGTCAGGGAGTAA	T8_Mem
TTCGGTCTCGCATGGC	T8_Mem_Prolif
TTCTACAAGTCCATAC	T8_Mem
TTCTACACAAACTGCT	T8_Mem
TTCTACAGTATGAAAC	T8_Mem
TTCTACAGTCTCTCGT	T8_Naive
TTCTCAACATGCTGGC	T8_Mem
TTCTCAATCCTATTCA	T8_Mem
TTCTCCTAGGCTATCT	T8_Mem
TTCTCCTGTGGCCCTA	T8_MAIT
TTCTCCTTCTTTAGGG	T8_Mem
TTCTTAGAGTAACCCT	T8_Naive
TTCTTAGCAATGACCT	T8_Mem
TTCTTAGGTTGTCGCG	T8_Mem
TTGAACGCAAAGGAAG	T8_Naive
TTGAACGTCAAGAAGT	T8_Mem
TTGACTTCAACACGCC	T8_Naive
TTGACTTCAAGCGTAG	T8_Naive
TTGACTTCAGAAGCAC	T8_Mem
TTGACTTCAGTAAGAT	T8_Mem
TTGACTTGTACATGTC	T8_Mem
TTGCCGTAGCATGGCA	T8_Mem
TTGCCGTAGGCTCTTA	T8_Mem
TTGCCGTAGTGCCATT	T8_Mem
TTGCCGTGTGTTAAGA	T8_Mem
TTGCCGTGTTAGAACA	T8_MAIT
TTGCCGTTCAGTCCCT	T8_Naive
TTGCCGTTCATGTCTT	T8_Naive
TTGCGTCAGATATGCA	T8_Mem
TTGCGTCAGTTCGCAT	T8_Mem_Prolif
TTGGAACGTAAATGAC	T8_Mem
TTGGAACGTACAGTTC	T8_Mem
TTGGAACGTCTTGATG	T8_Mem
TTGGAACTCTACTCAT	T8_Naive
TTGGCAAAGCCCAACC	T8_MAIT
TTGTAGGCAGCTGCTG	T8_Mem
TTGTAGGCATCACGAT	T8_Naive
TTGTAGGTCAACGGGA	T8_Mem
TTGTAGGTCGAACTGT	T8_Mem
TTTACTGAGGCGCTCT	T8_Mem
TTTACTGCAAGCCATT	T8_Naive
TTTACTGGTCAACTGT	T8_Naive
TTTACTGGTCTGATCA	T8_Mem
TTTACTGTCAACGGCC	T8_Mem
TTTATGCCAAGTACCT	T8_Mem
TTTATGCCAGCTGCAC	T8_Mem
TTTATGCCATTGGCGC	T8_Mem
TTTCCTCAGTAATCCC	T8_Mem
TTTCCTCGTGTTCTTT	T8_Mem
TTTCCTCTCCAGTAGT	T8_Mem
TTTGCGCAGAGTCGGT	T8_Mem
TTTGCGCCATGAGCGA	T8_Mem
TTTGCGCGTTATGCGT	T8_MAIT
TTTGGTTAGACAAAGG	T8_Mem
TTTGGTTCACTAAGTC	T8_Naive
TTTGGTTCATGCAACT	T8_Naive
TTTGGTTGTGCGAAAC	T8_Naive
TTTGTCAAGACTAGAT	T8_Mem
TTTGTCAAGCTAGCCC	T8_Mem
TTTGTCAGTCTAGTCA	T8_Mem
TTTGTCAGTGGTCCGT	T8_Mem
TTTGTCAGTTAAGAAC	T8_Mem
